新疆维吾尔自治区	新疆
临夏回族自治州	临夏
乐东黎族自治县	乐东
伊犁哈萨克自治州	伊犁
保亭黎族苗族自治县	保亭
克孜勒苏柯尔克孜自治州	克孜勒
凉山彝族自治州	凉山
博尔塔拉蒙古自治州	博尔塔拉
大理白族自治州	大理
巴音郭楞蒙古自治州	巴音郭楞
延边朝鲜族自治州	延边
德宏傣族景颇族自治州	德宏
怒江傈僳族自治州	怒江
恩施土家族苗族自治州	恩施
文山壮族苗族自治州	文山
昌吉回族自治州	昌吉
昌江黎族自治县	昌江
果洛藏族自治州	果洛
楚雄彝族自治州	楚雄
海北藏族自治州	海北
海南藏族自治州	海南
海西蒙古族藏族自治州	海西
湘西土家族苗族自治州	湘西
玉树藏族自治州	玉树
琼中黎族苗族自治县	琼中
甘南藏族自治州	甘南
甘孜藏族自治州	甘孜
白沙黎族自治县	白沙
红河哈尼族彝族自治州	红河
西双版纳傣族自治州	西双版纳
迪庆藏族自治州	迪庆
阿坝藏族羌族自治州	阿坝
陵水黎族自治县	陵水
黄南藏族自治州	黄南
黔东南苗族侗族自治州	黔东南
黔南布依族苗族自治州	黔南
黔西南布依族苗族自治州	黔西南
广西壮族自治区	广西
香港特别行政区	香港
澳门特别行政区	澳门
