松日	matsunichi
常熟	常熟市
娜丽斯	naris
河南农业职院	河南农业职业学院
于洪机场	沈阳于洪全胜机场
同济	同济大学
凯捷教育	凯捷职业教育学院
湘剧院	湘剧剧院
娄星	娄星区
瓦尔帕莱索	valparaiso
职防所	职业病防治所	职业病防研所	职业病防治研究所
宿松	宿松县
丰顺	丰顺县
中央工美	中央工艺美术学院
蓝白	蓝&白
东凯元	北京东凯元医药生物技术研究院
港口	港口区
晋中师专	晋中师范高等专科学校	晋中师范专科学校
双阳	双阳区
黔东南民族职院	黔东南民族职业技术学院	黔东南民族职业学院
国税局	国家税务局
璧山	璧山县
舞阳	舞阳县
新疆建设职院	新疆建设职业技术学院	新疆建设职业学院
首饰	珠宝	珠宝首饰
河北外语职业学院	河北外国语职业学院
西南6门	西南六门
工专	香港工业专门学院
沙坪坝	沙坪坝区
七里河	七里河区
l堂	l堂^
10小	第十小学	十小	第10小学
赣医	赣南医学院
西安科大高新学院	西安科技大学高新学院
漾濞	漾濞自治县	漾濞县	漾濞彝族自治县
潘婷	pantene
山亭	山亭区
涿州	涿州市
聊教院	聊城教育学院
中央工艺美院	中央工艺美术学院
贝儿多爸爸	贝儿多爸爸泡芙工房	贝儿多爸爸泡芙	贝儿多爸爸的泡芙工房
伊尔库茨克	irkutsk
竹北社大	竹北社区大学
鹿寨	鹿寨县
空指学院	空军指挥学院
南陵	南陵县
郑州市出入境管理处	郑州市公安局出入境管理处
博野	博野县
高娃钢琴幼儿园	北京高娃钢琴幼儿园
工商学院	工商职业学院	工商职院
电台	电视台
兰州石化职院	兰州石化职业技术学院	兰州石化职业学院
潮阳	潮阳区
京口	京口区
太原幼师	太原幼儿师范	太原幼儿师院	太原幼儿师范学院
庆元	庆元县
颍东	颍东区
革吉	革吉县
莱特艾斯	liteace
伏尔加河	volga
和田师专	和田师范专科学校
永吉实验高中	吉林省永吉实验高级中学
图森	tucson
永春	永春县
伊拉克	iraq	伊拉克共和国
彝良	彝良县
山西医大	山西医科大学	山西医科大
西南1门	西南一门
4	肆	四	第四	Ⅳ	no4	第4
桂阳	桂阳县
永川	永川区
湖州师范	湖州师范学院	湖州师院
元阳	元阳县
武职院	武汉职业学院	武汉职业技术学院
拉孜	拉孜县
莫桑比克	莫桑比克共和国
宁大	宁夏大学	宁波大学
幼稚园	幼儿园
阿拉善左	阿拉善左旗
盐工院	盐城工学院
底比斯	thebes
残疾者英语	广州残疾者英语培训中心
高新学院	西安高新技术培训学院
辽石化大	辽宁石化大学	辽宁石油化工大学
立信职大	立信会计职工大学
泰州科技学院	南理工泰州科技学院	南京理工大学泰州科技学院
田家庵	田家庵区
斯坦利	stanley
让胡路	让胡路区
绿园	绿园区
新余	新余市
艾美加	iomega
万杰医学院	山东万杰医学院
河北机关第一幼儿园	河北省直机关第一幼儿园
岭美	岭南美术专修学院
西北6门	西北六门
德美思嘉	dermalogica
发展研究中心	国务院发展研究中心
玛雅	maya
庆云	庆云县
瓦朗谢讷	valenciennes
得荣	得荣县
中石油	petrochina	中国石油	中国石油天然气股份有限公司
晓通学院	成都晓通网络工程学院
杭锦	杭锦旗
德国世家	drhauschka	dr.hauschka
自力学院	上海自力进修学院
森林防火指挥部	国家森林防火指挥部
澎科大	澎湖科技大学	澎湖科大
特瑞仕	torex
托博尔河	tobol
拿撒勒	nazareth
蓬江	蓬江区
斯隆商院	斯隆商学院
国家教育行政学院	国家高级教育行政学院
城市骆驼	nugate
邮储	邮政储蓄所	psbc	postalsavingsbankofchina	中国邮政储蓄银行	中国邮政储蓄银行有限责任公司	邮政储蓄银行	邮政银行	邮政储蓄
无锡科技职院	无锡科技职业学院
开远	开远市
市退职大	上海市退休职工大学
中华文学院	中华网络文学院
奉节	奉节县
三峡职院医学院	三峡职业技术学院医学院	三峡职业学院医学院
平南	平南县
欧莱雅	loréal	l'oréal	loreal	l'oreal
甘肃联大	甘肃联合大学
日电	nec	日本电气公司
开原	开原市
苏尼特左	苏尼特左旗
重庆民生职院	重庆民生职业学院	重庆民生职业技术学院
旧车中心	旧车交易中心	旧机动车中心	二手车交易市场	旧车交易市场	旧车市场	旧机动车交易市场	二手车中心	旧机动车市场	二手车市场	旧机动车交易中心	二手车交易中心
溆浦	溆浦县
圣地亚哥	santiago
东财津桥商学院	东北财经大学津桥商学院
斯托克波特	stockport
临翔	临翔区
新东方烹饪	南昌新东方烹饪学院	新东方烹饪学院
中科院	中国科学院	科学院
都兰	都兰县
上海交通职院	上海交通职业学院	上海交通职业技术学院
东莞科技学院	东莞科技进修学院
峰峰	峰峰矿区
伦敦德里	londonderry
太康	太康县
源城	源城区
淮北煤师院	淮北煤炭师范	淮北煤炭师范学院
福州海峡学院	福州海峡职业学院	福州海峡职院	福州海峡职业技术学院
山东劳动职院	山东劳动职业学院	山东劳动职业技术学院
台办	台务办公室	国务院台办	人民政府台务办	人民政府台湾事务办公室	国务院台湾事务办	政府台务办	台务办	国务院台湾事务办公室
上科院	上海科学院
czb	chinazheshangbank	浙商银行	浙商银行股份有限公司
中关村二小	中关村第二小学
中央电大残院	中央电大残疾人教育学院	中央广播电视大学残疾人教育学院
秘鲁	秘鲁共和国
美加托福专修	成都美加托福专修学校
三菱	mitsubish	mitsubishi
榆林医专	榆林医学专修学院
凉州	凉州区
三都	三都县	三都自治县	三都水族自治县
6小	第六小学	第6小学	六小
泾县电大	泾县广播电视大学
辽宁电大	辽宁广播电视大学
湖北轻工职院	湖北轻工职业学院	湖北轻工职业技术学院
马里亚纳群岛	marianaislands
中山学院	电子科技大学中山学院	电子科大中山学院	中山辅导学院
新疆维吾尔医专	新疆维吾尔医学专科学校
中研院	中央研究院
苏中机场	江都机场	苏中江都机场
温州成教学院	温州大学成教学院
成贤学院	东南大学成贤学院	东大成贤学院
武大出版社	武汉大学出版社
书苑	书屋	书城	书吧	书店	书社
残奥会	残疾人奥林匹克运动会
尧都	尧都区
俄罗斯	俄罗斯联邦	russia
托克逊	托克逊县
河东	河东区
亨思特	hnsat
百圣牛	pasnew
滁州	滁州市
唐山师范	唐山师范学院	唐山师院
武进	武进区
包头钢铁职院	包头钢铁职业技术学院	包头钢铁职业学院
武平	武平县
徐医	徐州医学院
计生协	计划生育协会	计生协会
鄂木斯克	omsk
华厦职院	华厦职业学院
上海外经贸	上海外经贸学院	上海对外贸易学院
沙河口	沙河口区
唐山职院	唐山职业技术学院	唐山职业学院
uob	大华银行(中国)有限公司	中国大华银行	大华银行	unitedoverseasbank
喀麦隆	喀麦隆共和国
凡尔登	verdun
肇庆工商职院	肇庆工商职业学院	肇庆工商职业技术学院
安吉机场	安吉直升机场
里加	riga
莱斯特郡	leicestershire
衡阳财经工业职院	衡阳财经工业职业技术学院	衡阳财经工业职业学院
浙江交通职院	浙江交通职业技术学院	浙江交通职业学院
石家庄艺术学校	石家庄市艺术学校
环卫处	环境卫生管理处
西双版纳	西双版纳市	西双版纳州	西双版纳傣族自治州	西双版纳自治州
范思哲	gianni	gianniversace	versace
东语学院	东方语言文化学院
川师文理学院	川师大文理学院	四川师范大学文理学院	四川师大文理学院
澜博	lambec
息烽	息烽县
乐都	乐都县
致公党	中国致公党
利兰	leyland
淮工院	淮海工学院	淮阴工学院
哈芭比	hellobarbie
华师南海附中	华师附中南海实验高级中学
乐东	乐东县	乐东自治县	乐东黎族自治县
兰理	兰理大	兰州理工大	兰州理工	兰州理工大学
经干院	经济干部管理学院	经济管理干部学院	经济干部学院	经管干
时尚女魔头	穿普拉达的女王	穿prada的恶魔
西安基大	西安基础大学
世妇会	世界妇女大会
米索尼	missoni
韶大	韶关学院	韶关大学
南充	南充市
贝司谱	bass谱
九州职院	九州职业技术学院	九州职业学院
适马	sigma
统计局	中华人民共和国国家统计局	国家统计局	中国国家统计局	中华人民共和国统计局
日喀则	日喀则地区	日喀则市
康乐	康乐县
天津交通职院	天津交通职业学院
江西建设职院	江西建设职业技术学院	江西建设职业学院
拉合尔	lahore
金秀	金秀自治县	金秀瑶族自治县	金秀县
市南	市南区
尼日利亚	尼日利亚联邦共和国	nigeaia
曼秀雷敦	mentholatum
恩平电大	恩平市广播电视大学
泸西	泸西县
云艺美术院	云南艺术学院美术学院
中大	中州大学	中山大学	中北大学
保山	保山市
宣恩	宣恩县
广东食品药品职院	广东食品药品职业学院
西塞山	西塞山区
综治办	社会治安综合治理委员会办公室
日产	日产尼桑	nissan	nissanmotor	尼桑
迪士尼	迪斯尼	disney
北经院	北京经济技术研修学院	北京经济研修学院	北京经济学院
南长	南长区
麦乐	merrell
宁夏财经职院	宁夏财经职业学院
呼兰	呼兰区
城规院	城市规划学院	城规学院
kejian	中国科健股份有限公司
上海电大	上海广播电视大学
青岛汇众	青岛汇众教育动漫游戏学院
明山	明山区
河北工业职院	河北工业职业学院	河北工业职业技术学院
浙江旅职	浙江旅游职院	浙江旅游职业学院
湘教院	湘潭教育学院
机电职大	上海机电工业职工大学
atm	24小时自助银行	24小时自动取款机	二十四小时自动取款机	atm自动取款机	24小时取款机	二十四小时取款机	atm自动银行	二十四小时自助银行	自动取款机	取款机	atm取款机	自助银行
兖州	兖州市
拉萨尔学院	东华拉萨尔国际设计学院	拉萨尔国际设计学院	东华大学拉萨尔国际设计学院
保靖	保靖县
杭州	杭州市
新奥尔良	neworleans
美国高通公司	qualcomm
翁牛特	翁牛特旗
浮山	浮山县
南教院	南昌教育学院	南宁教育学院	南宁地区教育学院
赛琳	celine
泸定	泸定县
逸香园	逸香苑
德劲	degen
浩鑫	shuttle
哈尔滨铁道职院	哈尔滨铁道职业学院	哈尔滨铁道职业技术学院
眼镜	眼镜店
北环路中学	河北定州市北环路初级中学
桂林山水职院	桂林山水职业学院
柳河	柳河县
达贸	delmas	达贸国际
广工院鹿山学院	广西工学院鹿山学院
马拉博	malabo
晨鹰	新乡市晨鹰科技研究所
上海事职院	上海事职业技术学院	上海事职业学院
运城幼儿师专	运城幼师专科学校	运城幼儿师范高等专科学校
一二三东北菜	123东北菜
云梦	云梦县
长春景春色机学院	长春景春色学周详机械学院
特派办	特派员办事处
旌宇	sparkle
屯昌县
仲恺农学院	仲恺农业工程学院	仲恺农业学院
巴林右	巴林右旗
潞西	潞西市
巴彦	巴彦县
贝纳通	benetton
美利纸业	美丽纸业
复旦医学院	复旦大学医学院	复旦大学上海医学院
东2门	东二门
家居	家居用品	家居饰品
莱州	莱州市
四川化工职院	四川化工职业技术学院	四川化工职业学院
梅华街道办	珠海市香洲区梅华街道办事处
环保部	中华人民共和国环保部	中华人民共和国环境保护部	中国环境保护部	环境保护部	国家环境保护部
旅游局	中国国家旅游局	中华人民共和国国家旅游局	中华人民共和国旅游局	国家旅游局
苏台德山脉	sudety
新加坡	新加坡共和国	singapore
云南三鑫职院	云南三鑫职业技术学院	云南三鑫职业学院
日照职院	日照职业学院	日照职业技术学院
逊克	逊克县
石首	石首市
洛斯	loews
宣城电大	宣城广播电视大学
北航计算机学院	北京航空航天大学计算机学院
石市	石家庄	石家庄市
巴厘岛	巴里岛
余杭	余杭区
融智学院	重庆工商大学融智学院
江门电大	江门市广播电视大学
中防学院	中国防卫科技学院
江西应用工程职院	江西应用工程职业学院
金大福	金大福珠宝
苏禄群岛	suluarchipelago
南海工业学校	广东茂名市南海工业科技学校
卢龙	卢龙县
河北社科院	河北省社会科学院
本色	benss
张家港	张家港市
花莲师范	花莲师范学院	花莲师院
法巴	中国法国巴黎银行	巴黎国民银行	中国巴黎银行	法国巴黎银行	巴黎银行	法国巴黎银行(中国)有限公司	bnpparibas
河南	河南自治县	河南县	河南蒙古族自治县	河南省
乔治威斯顿	georgeweston
依诺斯	eudos
新侨职院	新侨职业学院	新侨职业技术学院
千阳	千阳县
察哈尔右翼后	察哈尔右翼后旗
西安体院	西安体育学院
上工大	上海工程技术大学	上海工技大
礼院	礼仪高等女子学院
sgcc	stategrid	国家电网公司
伊宁机场	新疆伊宁机场
闽南理工	闽南理工学院
利维肤	revive
蒙得维的亚	montevideo
湄潭	湄潭县
米林	米林县
基尔肯尼	kilkenny
汉源	汉源县
广州工商职院	广州工商职业学院	广州工商职业技术学院
黔东南	黔东南自治州	黔东南市	黔东南州	黔东南苗族侗族自治州
泽库	泽库县
特隆赫姆	trondheim
庐山机场	九江庐山机场	九江机场
鸠江	鸠江区
陕师大网络学院	陕师大网络教育学院
石经院华信学院	石家庄经济学院华信学院
莱斯博斯岛	lespos
店	分店
辽职院	辽宁职业学院
中经大	中国科技经营管理大学
陕西社院	陕西社会主义学院
劳斯莱斯	rollsroyce	rolls-royce
翁源	翁源县
首工院	首钢工学院
甘肃农业职院	甘肃农业职业学院	甘肃农业职业技术学院
北物院	北京物资学院	物资学院
奥索卡	ozark
水院	水产学院
西安外事	西安外事学院
富民	富民县
淮北师大信息学院	淮北师范大学信息学院
汽配城	汽配市场	汽车配件城	汽车配件市场
宁阳	宁阳县
药科院	山东省药学科学院
普洱	普洱市
昆明金鹰艺术学校	昆明金鹰艺术培训学校
广大外语学院	广西大学外国语学院	广大外国语学院
庐江	庐江县
局	分局
默寇利	mercury
桓台	桓台县
天津冶金职院	天津冶金职业技术学院	天津冶金职业学院
军事医科院	军事医学科学院
帝凡尼	tiffany
西畴	西畴县
内罗毕	nairobi
禄劝	禄劝彝族苗族自治县	禄劝县	禄劝自治县
琼院	琼州学院
西充	西充县
武汉机场	天河机场	武汉天河国际机场	武汉国际机场	天河国际机场
东山	东山区	东山县
昆明扬帆职院	昆明扬帆职业技术学院	昆明扬帆职业学院
天柱	天柱县
应外院	应用外语学院
阳春	阳春市
穗华学院	穗华科技专修学院
凌河	凌河区
邻水	邻水县
西城	西城区
大庆	大庆市
洛扎	洛扎县
郾城	郾城区
宁南	宁南县
labthink兰光	济南兰光机电技术发展中心
盐山	盐山县
西岛区	westernisles
沃达丰	vodafone
凌海	凌海市
外央电大	外央广播电视大学
wto	worldtradeorganization	世界贸易组织
雅马哈	yamaha
党代会	党代表大会
托木斯克	tomsk
惠济	惠济区
内蒙古人文学院	内蒙古人文技能专修学院
商丘	商丘市
侨友学院	上海侨友外语进修学院
辛普朗	simplon
昭通	昭通市
商区	商业区
西华	西华县	西华大学
磐正	磐英	epox	盘正
佛山职院	佛山职业技术学院	佛山职业学院
娇韵诗	clarins
海关总署	中国海关总署	国家海关总署	中华人民共和国海关总署
广州华夏职院	广州华夏职业学院
万州二中	重庆市万州第二高级中学
灵芝	灵芝草
大成建设	taisei
勤修职院	勤修职业技术学院	勤修职业学院
圭亚那	圭亚那合作共和国
汤加	tonga	汤加王国
广州电大	广州市广播电视大学
四川现代职院	四川现代职业学院
底格里斯河	tigris
泰州学院	南京师范大学泰州学院	南师大泰州学院
湖南安全技术职院	湖南安全技术职业学院
湘潭	湘潭县	湘潭市
河大	河北大学	河南大学	河套大学
重庆商务职院	重庆商务职业学院
马代夫	maldives
安徽经管干	安徽经济管理干部学院
山西兴华职院	山西兴华职业学院
武城	武城县
惠阳	惠阳区
经职院	经济职业技术学院	经济职业学院
中国国际科学合作协会	中国国际科学技术合作协会
湖南社院	湖南省社会主义学院
陆川	陆川县
俄亥俄	ohio
士林社大	台北市士林社区大学
山东外事翻译职院	山东外事翻译职业学院
太谷	太谷县
陕航职大	陕西航天职工大学	航天职工大学
南京汤包	南京特色汤包	南京灌汤包
紫金学院	南理工紫金学院	南京理工大学紫金学院
焦作	焦作市
广州航专	广州航海高等专科学校	广州航海专科学校
乌达	乌达区
新东方烹饪学校	江西新东方烹饪学院
纽约客	newyorkstylepizza	newyorker
德亚	targa
飞思	phaseone
化工大学北方学院	北京化工大学北方学院
渤海文理学院	渤海大学文理学院
北京政法职院	北京政法职业学院
且末	且末县
吧比馒头	巴比馒头	芭比馒头
赢嘉	howin
德阳	德阳市
称多	称多县
湖北经院	湖北经济学院
临高县
欧文学院	上海欧文经济进修学院
甘德	甘德县
业余法大	业余法律大学
南通机场	兴东机场	南通兴东机场
中阳	中阳县
重商大	重庆工商大学
忻府	忻府区
港北	港北区
文山社大	文山社区大学
绥棱	绥棱县
洛奇代尔	rochdale
内工大	内蒙古工大	内蒙古工业大学
无锡机场	无锡苏南硕放国际机场	苏南硕放机场	苏南硕放国际机场	无锡国际机场
南门	南大门	南门口
周一	星期一	礼拜一
金阳	金阳县
北指	武警北京指挥学院	北指学院	中国人民武装警察部队北京指挥学院
南明	南明区
江西赣江职院	江西赣江职业学院	江西赣江职业技术学院
重庆能源职院	重庆能源职业学院
呈贡	呈贡县
浑源	浑源县
创媒学院	昆山科大创意媒体学院
萨尔图	萨尔图区
房山	房山区
中财	中央财经大学	中央财大	中国财经	中财院	中国财大	中财大学	中山财经	中国财经大学	中山财院	中山财经专修学院
麦奈海峡	menaistrait
泉州师范	泉州师范学院	泉州师院
越剧	绍兴戏
山西综合职院	山西综合职业技术学院	山西综合职业学院
ocbc	ocbcbank	中国华侨银行	华侨银行	华侨银行(中国)有限公司
丹吉尔	tangier
台科大	台湾科技大学	台湾科大
上海译文	上海译文出版社
海晏	海晏县
新疆生态与地理研究所	中国科学院新疆生态与地理研究所
辽宁交专	辽宁交通高等专科学校	辽宁交通专科学校
萨尔瓦多	萨尔瓦多共和国	salvador
东华理工长江学院	东华理工大学长江学院
蒂龙	tyrone
临汾职院	临汾职业技术学院	临汾职业学院
昆山	昆山市
南丹	南丹县
原阳	原阳县
佛莱格默	ferragamo
勤科大	勤益科大	勤益科技大学
许昌职院	许昌职业学院	许昌职业技术学院
布庄	布店
人大商学院	中国人大商学院	中国人民大学商学院	人民大学商学院
斯特拉斯克莱德	strathclyde
成都航空职院	成都航空职业技术学院	成都航空职业学院
沙市职大	沙市职业大学
茂职院	茂名职业技术学院	茂名职业学院
艾礼富	aleph
现代远程教育学院	北京航空航天大学现代远程教育学院	北航现代远程教育学院	北航远程教育学院
湖北经院法商学院	湖北经济学院法商学院
长阳	长阳自治县	长阳县	长阳土家族自治县
喀纳斯机场	喀纳斯直升机场
川美	四川美术学院
右江	右江区
三联职业技术学院	安徽三联职业技术学院
锦州机场	锦州小岭子机场	小岭子机场
夏普	sharp
吉林经管干	吉林省经济管理干部学院	吉林经济管理干部学院
湖南化工职院	湖南化工职业学院	湖南化工职业技术学院
利帕里群岛	lipairislands
山西交通职院	山西交通职业技术学院	山西交通职业学院
武汉船舶职院	武汉船舶职业技术学院	武汉船舶职业学院
四川机电职院	四川机电职业学院	四川机电职业技术学院
金融工程学院	南开大学深圳金融工程学院	南大深圳金融工程学院
西指	西指学院	中国人民武装警察部队西安指挥学院	武警西安指挥学院
摩洛哥	morocco	摩洛哥王国
湖南工大科技学院	湖南工业大学科技学院
海职院	海南职业学院	海南职业技术学院
8院	八医院	第八人民医院	第8医院	第八医院	八院	第8人民医院	8医院
创齐	transystar
浙江经贸职院	浙江经贸职业技术学院	浙江经贸职业学院
会泽	会泽县
北8门	北八门
北爱尔兰	northernisland
天大职教学院	天津大学职业教育学院	天大职业教育学院
汉台	汉台区
深港驾校	深港学车
南林大	南京林业大学	南京林大
南充职院	南充职业学院	南充职业技术学院
民大职技学院	内蒙古民族大学职业技术学院
轨院	轨道交通学院
三石糕点学院	三石糕点技术培训学院
西5门	西五门
酒楼	酒馆	酒家
五金	五金配件	五金工具
太平机场	太平国际机场	哈尔滨太平国际机场	哈尔滨机场	哈尔滨国际机场
湛江师院	湛江师范	湛江师范学院
广东	广东省
河北公安职院	河北公安警察职业学院	河北公安警察职院
武指长春分院	武警指挥学院长春分院	中国人民武装警察部队指挥学院长春分院
泰宁	泰宁县
北6门	北六门
武汉科技职院	武汉科技职业学院
桂东	桂东县
菏泽	菏泽市
声力士	cenix
西山	西山区
蒙哥马利郡	montgomeryshire
大华第一小学	上海市大华第一小学
朝阳	朝阳市	朝阳区	朝阳县
菱花学院	菱花贵族学院
浪潮	inspur
柳州师专	柳州师范高等专科学校	柳州师范专科学校
苹果	apple
沾益	沾益县
福州	福州市
温得和克	windhoek
华东交大理工学院	华东交通大学理工学院
玉溪农业职院	玉溪农业职业学院	玉溪农业职业技术学院
高港	高港区
百慕大	百慕大群岛
德为先	德为先学校俱乐部
新和	新和县
峨山	峨山自治县	峨山县	峨山彝族自治县
江苏农林职院	江苏农林职业技术学院	江苏农林职业学院
川汇	川汇区
温州	温州市
恒翔	hunsan
提萨河	tisza
巴州电大	巴州广播电视大学
德州	德州市
江师大	江西师大	江西师范大学	江西师范
岑溪	岑溪市
曲靖市农函大	曲靖市农村致富技术函授大学
马里兰	maryland
石泉	石泉县
山西煤炭职院	山西煤炭职业学院	山西煤炭职业技术学院
电监办	电力监管委员会监管办公室	国家电力监管委员会监管办公室
黄梅	黄梅县
培华	西安培华	西安培华学院
霍邱	霍邱县
古丈	古丈县
福建交通职院	福建交通职业学院	福建交通职业技术学院
南开职大	南开区职工大学
巴黎仙	parisienne
崂山	崂山区
琼山	琼山区
光泽	光泽县
阳西	阳西县
池州	池州市
吉布提	吉布提共和国
河北软件职院	河北软件职业技术学院	河北软件职业学院
建工	建院	建工学院	建筑工程学院	建筑学院	建筑工学院
先马	sama
浪琴	longines
育林日语学院	育林日本语学院
名词委	名词委会	名词审定委员会
合肥机场	合肥骆岗国际机场	骆岗机场	合肥骆岗机场
江西交通职院	江西交通职业技术学院	江西交通职业学院
建材	建材装修	建材装饰
铜川	铜川市
广东工程职院	广东工程职业技术学院	广东工程职业学院
盐源	盐源县
江苏	江苏省
衡阳师院南岳学院	衡阳师范学院南岳学院
哥伦比亚	columbia	哥伦比亚共和国
粮管所	粮食管理所
兽医学	兽医医学
晋安	晋安区
建昌	建昌县
丹棱	丹棱县
马力昂	marea
大连理工软件学院	大连理工大学软件学院
城市管理学院	上海市城市管理学院
东昌	东昌区
岳阳职院	岳阳职业学院	岳阳职业技术学院
阳东	阳东县
色达	色达县
金融学院	太平洋金融学院	上海高级金融学院
可口可乐	cocacola	coca-cola
海南政法职院	海南政法职业学院
比什凯克	bishkek
陕西交通职院	陕西交通职业技术学院	陕西交通职业学院
围场	围场满族蒙古族自治县	围场县	围场自治县
益阳科协	益阳市科学技术协会
昌吉电大	昌吉广播电视大学
计生	计划生育
北方学院	河北北方学院
罗纳河	rhone
南工院	南京工学院	南京工程学院	南昌工学院	南昌工程学院
时珍学院	中医药学院时珍学院	贵阳中医学院时珍学院	贵阳中医院时珍学院	贵阳中医药时珍学院	中医药时珍学院	中医院时珍学院	贵阳中医药学院时珍学院	中医学院时珍学院
怀化机场	芷江机场	怀化芷江机场
桂林十八中	桂林市第十八中学
陕西社科院	陕西省社会科学院
二七	二七区
饶平师范附小	饶平县师范附属小学
铁力	铁力市
东财	东北财经	东财大学	东北财大	东北财经大学
渤海船舶职院	渤海船舶职业学院
青山	青山区
聊大东昌学院	聊城大学东昌学院
鼎城	鼎城区
连云港	连云港市
畅游有限公司	changyou.comlimited	changyou
4小	四小	第四小学	第4小学
临湘	临湘市
大连	大连市
智利	智利共和国
麻章	麻章区
教委	教育委员会	教育工委会	教育工作委员会	教工委
电脑商网	电脑商学院
水磨沟	水磨沟区
天全	天全县
泽普	泽普县
长宁	长宁区	长宁县
商洛职院	商洛职业技术学院	商洛职业学院
志盟	zmeng	z-meng
琼中	琼中黎族苗族自治县	琼中自治县	琼中县
山东职院	山东职业技术学院	山东职业学院
市建委	洛阳建委	洛阳市建设委员会	洛阳建设委员会
上海	上海市
青神	青神县
宜州	宜州市
潘集	潘集区
海友客栈	汉庭海友客栈
广西英华国际职院	广西英华国际职业学院
星海学院	星海音乐学院
海心塔	广州塔	广州新电视塔	小蛮腰
南通电大	南通广播电视大学
韦茅斯	weymouth
万虹	vancom
湖工院应用学院	湖南工程学院应用学院
环保办	环境保护管理委员会办公室	环保委员会办公室	环境保护委员会办公室
鄢陵	鄢陵县
翼城	翼城县
优方	perfectpotion
旌阳	旌阳区
顺德职院	顺德职业学院	顺德职业技术学院
福大管理学院	福州大学管理学院
业图	长春市业余图书馆学院
巨野	巨野县
建瓯	建瓯市
科委	科技委	科学技术委员会	科技委会
林都机场	伊春林都机场	伊春机场
展厅	展室
中旅院	中国旅游管理干部学院
舞钢	舞钢市
新乡农科院	新乡市农业科学院
农发行	adbc	agriculturaldevelopmentbankofchina	农业发展银行	中国农业发展银行
约翰斯顿岛、豪兰岛、贝克岛和威克岛等)
汕头	汕头市
花都电大	花都广播电视大学
振兴东北地区等老工业基地领导小组	国务院振兴东北地区等老工业基地领导小组
浦东	浦东新区	浦东区
邵阳	邵阳县	邵阳市
兴海	兴海县
南农	东北农业大学	华农	华南农业大学	中国农大	华南农大	沈阳农业大学	农大	四川农大	东北农大	华中农业大学	东农大	南京农业大学	川农大	南京农大	华中农大	南农大	华农大	中国农业大学	中农大	农业大学	川农	四川农业大学	沈阳农大	中农	东农
丹巴	丹巴县
融水	融水县	融水自治县	融水苗族自治县
cttc	亚洲智能控制有限公司
民建	中国民主建国会
崇礼	崇礼县
林芝	林芝地区	林芝县	林芝市
徐州民主路小学	江苏省徐州市民主路小学
张家川	张家川自治县	张家川回族自治县	张家川县
江海职院	江海职业技术学院	江海职业学院
乌尔禾	乌尔禾区
长沙社院	长沙市社会主义学院
赣州	赣州市
商丘科技职院	商丘科技职业学院
华为	huawei
邯山	邯山区
北华	北华大学
肥西	肥西县
东方美术职院	东方美术职业学院	石家庄东方美术职业学院
北化	北化大	化工大学	北京化工大	化工大	北京化大	化大	北京化工大学
湖南铁道职院	湖南铁道职业学院	湖南铁道职业技术学院
科特迪瓦	科特迪瓦共和国
民进	中国民主促进会
西北3门	西北三门
重庆邮大移通学院	重庆邮电大学移通学院
九百碗	九佰碗
10院	第十医院	10医院	第10医院	十院	十医院	第10人民医院	第十人民医院
诺尔雪平	norrkoping
绥化	绥化市
肯特	kent
电车站	电车车站
安平	安平县
飞兆	fairchild
中四路小学	重庆市渝中区中四路小学
云南省农函大	云南省农村致富技术函授大学
东方胃病研究所	河南省安阳市东方胃病研究所
姿燕莎水疗	姿燕莎水疗美容学院
兴和	兴和县
波多黎各	波多黎各自由联邦
上海建筑材料协会	上海市建筑材料行业协会
南京金肯职院	南京金肯职业技术学院	南京金肯职业学院
北理工珠海学院	北京理工大学珠海学院	北京理工珠海学院
国防部	中国国防部	国家国防部	中华人民共和国国防部
数据王	datace
太原旅游职院	太原旅游职业学院
公疗	公费医疗
贵医神奇民族医药学院	贵阳医学院神奇民族医药学院
医管院	医药卫生管理学院
宜州一中	广西宜州一中
cpic	中国太平洋保险(集团)股份有限公司
遵义	遵义县	遵义市
地大珠宝	北京珠宝学院	中国地大珠宝学院	地大(武汉)珠宝学院	中国地质大学珠宝学院	地大珠宝学院	地质大学(武汉)珠宝学院	武汉珠宝学院	地质大学珠宝学院	中国地大(武汉)珠宝学院	中国地质大学(北京)珠宝学院	珠宝学院	中国地质大学(武汉)珠宝学院	中国地大(北京)珠宝学院
吉尔吉斯斯坦	吉尔吉斯共和国
四川建筑职院	四川建筑职业学院	四川建筑职业技术学院
全南	全南县
天梭	tissot
重科信息学院	重庆科技学院电子信息工程学院
凌力尔特	linear
扎兰屯	扎兰屯市
雁峰	雁峰区
东北9门	东北九门
淮南师院	淮南师范	淮南师范学院
枫叶职院	枫叶职业学院	大连枫叶职业技术学院
参大	参谋大学
集宁	集宁区
南汇电大	上海南汇电视大学
默克	merck
遵医	遵义医学院
未央	未央区
滕州实验中学	滕州实验高级中学
暗宅之谜	暗宅之迷
盘山	盘山县
宏基	acer	宏集团	宏
西德福	stauff
hoc	雅美达
云南爱因森软件职院	云南爱因森软件职业学院
五建网络学院	五建设有限公司网络培训学院
来凤	来凤县
1小	一小	第1小学	第一小学
恩维达	nvidia
涵江	涵江区
大麻哈鱼	大马哈鱼
外事侨务办	外事侨务办公室	政府外事侨务办	人民政府外事侨务办	人民政府外事侨务办公室
博思堂	birthidea博思堂
武江	武江区
天音学院	天津音乐学院
邢台国家粮库	河北邢台国家粮食储备库
利阿兹	liaz
阿合奇	阿合奇县
松山职院	松山职业学院	松山职业技术学院
西南2门	西南二门
辽宁地质工程职院	辽宁地质工程职业学院
8中	第八中学	八中	第8中学
广电学院	华北广播电影电视管理干部学院
千福	千福体检
世行学院	世界银行学院
贝鲁特	beirut
甘州	甘州区
太平	太平区
萧山农校	萧山农业技术学校
白城师范	白城师范学院	白城师院
市社科院	南宁市社会科学院
平利	平利县
重大	重庆大学
淮安信息职院	淮安信息职业学院	淮安信息职业技术学院
华北水院	华北水电学院	华北水利水电学院
广电总局	国家广播电影电视总局	国家广电总局	广播电影电视总局
多巴哥岛	tobago
浙江商职院	浙江商业职业学院	浙江商业职业技术学院
天水师范	天水师范学院	天水师院
镇江	镇江市
s大仙	s大仙^
平乐	平乐县
苏尼特右	苏尼特右旗
南方学院	中国南方学院
梅森大学	乔治梅森大学
深圳消息职院	深圳消息职业技术学院	深圳消息职业学院
衢州	衢州市
能源办	能源办公室
xu	xu^
簋街	鬼街
小河	小河区
安阳师院人文管理学院	安阳师范学院人文管理学院
网银	网上银行
长春金融专科学校	长春金融高等专科学校
新星医药研究	新星医药研究所
衢州职院	衢州职业学院	衢州职业技术学院
商城	商城县
淘大	浙江淘宝网络有限公司淘宝大学
上海电子信息职院	上海电子信息职业学院	上海电子信息职业技术学院
文成	文成县
福建医大	福建医科大	福建医科大学
英泰移动通信	武汉英泰移动通信学院
武陟	武陟县
杨国福	杨国福麻辣烫连锁
cyts	中青旅控股股份有限公司
台安	台安县
黄平	黄平县
黄冈科技职院	黄冈科技职业学院
商场	购物广场	百货商场	百货商厦	购物中心	购物商厦	百货	购物商场	购物商城	商厦	大商场
轻骑兵	lancer
索非亚	sofia
桑植	桑植县
列支敦士登	列支敦士登公国	liechtenstein
米蒂利尼	mytilene
北京布尔玛	北京布尔玛国际花艺培训学校
江苏食品职院	江苏食品职业学院	江苏食品职业技术学院
章丘	章丘市
公路学院	西安公路学院	长安大学公路学院
兴宁	兴宁区	兴宁市
北岳职院	北岳职业学院	北岳职业技术学院
shoufang	搜房资讯有限公司
金山屯	金山屯区
水产品	水产产品
望城	望城县
河南经贸职院	河南经贸职业学院
相城	相城区
湘西	湘西市	湘西州	湘西土家族苗族自治州	湘西自治州
中广协	中国广告协会
益阳	益阳市
香港亚视	香港atv	亚洲电视
仰恩	仰恩大学
青北外院	青岛北方对外教育交流学院
黑工院	黑龙江工程学院	黑龙江工学院
内蒙古警察职院	内蒙古警察职业学院
晋剧	山西梆子
沈阳鲁美	沈阳鲁迅美术学院
江山	江山市
曼富图	manfrotto
2	第2	贰	第二	二	Ⅱ	no2
韩城	韩城市
阿尔帕	alpa
卢萨卡	lusaka
北海职院	北海职业学院
中学生	中学学生
神学院	神学学院
清华信科院	清华信息科学学院	清华大学信息科学学院
茶室	茶艺馆	茶楼	茶艺社	茶庄	茶艺园	茶馆	茶艺行	茶艺室	茶坊	茶艺庄	茶社	茶艺厅	茶艺轩
马坎山	markham
文化大学	中国文化大学
卧龙	卧龙区
公路局	公路管理局
博斯腾湖管理局	新疆博斯腾湖管理局
大地学院	上海大地文化进修学院
绵阳成绵路小学	四川省绵阳市成绵路小学
新西伯利亚	novosibirsk
灌阳	灌阳县
渤大	渤海大学
郑大远程教育学院	郑州大学远程教育学院
丹麦	丹麦王国
东方汇理银行	东方汇理银行(中国)有限公司	banquedel'indochine	中国东方汇理银行
大连交大信息工程学院	大连交通大学信息工程学院
航星	navistar
重庆铜师附小	重庆市铜梁师范学校附属小学
柞水	柞水县
广本	广州本田
四平	四平市
卡地亚	cartier
莆院医学院	莆田学院医学院
华清学院	广东华清专修学院
数媒艺大	数字媒体艺术大学
北京洋桥职校	北京市洋桥职业学校
圆通	圆通物流	yoto	圆通快递	圆通速递
南丰	南丰县
饮食	美食	餐饮
河南职院	河南职业学院	河南职业技术学院
辽师大	辽宁师范	辽宁师范大学	辽宁师大
银川机场	银川河东机场	河东机场
西沃德半岛	sewardpeninsula
襄院理工学院	襄樊学院理工学院
南芬	南芬区
福利会幼儿园	中国福利会幼儿园
乡企学院	沈阳乡镇企业学院
稻城	稻城县
滨海机场	天津滨海国际机场	天津机场	天津国际机场	滨海国际机场
建始县一中	湖北省建始县第一中学
保亭	保亭自治县	保亭县	保亭黎族苗族自治县
南非	南非共和国
天津职大	天津职业大	天津职业大学
长大	长春大学	长江大学	长安大学
北京京北职院	北京京北职业技术学院	北京京北职业学院
厨卫	厨卫用品	厨卫用具	厨卫挂件
农工大	农业工程大学
密斯迪	misitque
琼剧院	琼剧剧院
双柏	双柏县
建材轻工院	北京联合大学建材轻工学院
麦肯基	麦肯基快餐国际连锁
内布拉斯加	nebraska
北服院	北京服装学院
大通电大	大通广播电视大学
义马	义马市
阿特	opti
上海建桥	上海建桥学院
中山电大	中山市广播电视大学
妇幼医院	妇儿医院	妇女儿童医院	妇女幼儿医院
同仁	同仁县
社科大	广东社会科学大学
长春	长春市
户口册	户口本	户口簿
中大信息商务学院	中北大学信息商务学院
飞机工业公司职工学院	西安飞机工业公司职工工学院
铅山	铅山县
大连装备制造职院	大连装备制造职业学院	大连装备制造职业技术学院
义乌市蛇类研究所	浙江义乌市蛇类研究所
郑州师专	郑州师范高等专科学校
芬兰	芬兰共和国
黑龙江	黑龙江省
重庆电力专科学校	重庆电力高等专科学校
崇安	崇安区
德宏	德宏州	德宏市	德宏自治州	德宏傣族景颇族自治州
3	叁	三	第三	Ⅲ	第3	no3
拉赛尔山脉	laselle
新竹教大	新竹教育大学
黑龙江护理专科学校	黑龙江护理高等学校	黑龙江护理高等专科学校
西6门	西六门
工委	街工委	街道工委会	工委会	街道工作委员会	工作委员会
武汉商职院	武汉商贸职业学院	武汉商学院	武汉商贸学院
素菜	素菜馆
萨克森	saxony
海北	海北自治州	海北藏族自治州	海北州	海北市
店口镇中心幼儿园	诸暨市店口镇中心幼儿园
上海馄饨	上海混沌
上海师大天华学院	上海师范大学天华学院
宿豫	宿豫区
广濑电机	hirose
便民店	便民商店	便民超市
永州机场	永州零陵机场	零陵机场
省少科院	山东省少年科学院
汉中机场	汉中西关机场	西关机场
信大	信州大学
作协	作家协会
广东工贸职院	广东工贸职业技术学院	广东工贸职业学院
叙永	叙永县
狮麟驾校	南京交通狮麟驾驶学院
交大医学院	上海交通大学医学院
山线社大	台中县山线社区公民大学
云财	云南财大	云财大学	云南财经	云南财经大学
四维动漫学院	四维梦工场动漫学院
天津电大	天津广播电视大学
空工	解放军空军工程大学	空军工程大学	中国人民解放军空军工程大学	空工院
工大高等职业教育学院	北京工业大学高等职业教育学院
新抚	新抚区
华南理工广州汽车学院	华南理工大学广州汽车学院
长春电大	长春广播电视大学
金马学院	金马电脑专修学院
硫黄列岛	volcanoislands
农行	abc	agriculturalbankofchina	中国农业银行股份有限公司	中国农行	中国农业银行	农业银行
中联司法学院	中国继续教育联合学院司法学院
本溪职专	本溪市高等职业专科学校	本溪职业专科学校
阜阳科技职院	阜阳科技职业学院
四川公路职业学校	四川省公路职业技术学校
曲靖师院	曲靖师范学院	曲靖师范
温泉	温泉县
聊城电大	聊城广播电视大学
新干	新干县
捷信	gitz
河理	河南理工大学	河南理工	河南理工大	河理大	河北理工大	河北理工	河北理工大学
渭源	渭源县
西安三资职院	西安三资职业学院
鸡泽	鸡泽县
二道江	二道江区
石家庄职工大	石家庄职工大学
得克萨斯	texas
中科创研节能	北京中科创研节能技术研究院
少年国学院	中华少年国学院
中行	中银	bankofchina	中国银行股份有限公司	中国银行	bc
广西卫管干	广西自治区卫生管理干部学院	广西卫管干学院
德德玛学院	呼和浩特市德德玛艺术音乐专修学院
米拉	mira
郑州航空工业管理学院统计职院	郑州航空工业管理学院统计职业学院
陇南师专	陇南师范高等专科学校	陇南师范专科学校
重庆三峡职院	重庆三峡职业学院
法学会	法学学会
西职学院	宁夏西部职业经理培训学院
基加利	kigali
西安一中	西安市第一中学
新都	新都区
太原电专	太原电力高等专科学校	太原电力专科学校
察隅	察隅县
1中	第1中学	第一中学	一中
潍坊机场	潍坊南苑机场	海航潍坊南苑机场
沃尔格林	walgreen
灵寿	灵寿县
拉格比	rugby
敬老院	养老院
衡水职院	衡水职业学院	衡水职业技术学院
常州纺织服装职院	常州纺织服装职业学院	常州纺织服装职业技术学院
陈旗	陈巴尔虎	陈巴尔虎旗
和平机场	日喀则和平机场	日喀则机场
尚格艺术学院	北京尚格益动数字艺术学院
东安	东安区	东安县
南郊机场	绵阳机场	绵阳南郊机场
纪委	纪律检查工作委员会	纪律检察委员会	纪检委	纪律检查委员会
米兰	milan
兰德学院	兰德商务语言学院
雷登	demonstar
重通	通信学院	重庆通院	重庆通信学院
东昌府	东昌府区
长教院	长沙教育学院
达卡	dhaka
管委	管理委员会	管委会
图象	图像
发改局	发展和改革局
内建院	内蒙古建筑学院
山西信息职院	山西信息职业技术学院	山西信息职业学院
云岩	云岩区
长沙新东方	长沙新东方烹饪学院
岳池	岳池县
郸城	郸城县
重庆指南针计算机	重庆指南针计算机学院
衡水师专	衡水师范专科学校
闽清	闽清县
沃里克郡	warwickshire
美雅学院	湖南大学美雅国际教育学院	湖大美雅学院
大名	大名县
东莞职院	东莞职业学院	东莞职业技术学院
圣贝纳迪诺山脉	sanbernardino
安吉	安吉县
京华学院	龙京清华学院
南安红星职专	福建省南安红星职业中专学校
卓普	zopo
上大	上海大学
登云科技职院	登云科技职业学院
电教	电化教育
重庆社科院	重庆市社会科学院	重庆社会科学院
西科	成都西科航空专修学院
山东体院	山东体育学院
北外贸	北京对外商贸管理研修学院
班尼路	banleno	baleno
焦作师专	焦作师范高等专科学校	焦作师范专科学校
宁大资环学院	宁夏大学资源环境学院
costa	costacoffee
瓯海	瓯海区
樟树	樟树市
忻州职院	忻州职业技术学院	忻州职业学院
华科院	华北科技学院
香洲	香洲区
希巴利斯	sybaris
爱特爱	爱特爱服饰
赣南师院科技学院	赣南师范学院科技学院
高尔夫	golf
吉之岛	jusco
黄石理工	黄石理工学院
比利时	比利时王国
重庆城市职院	重庆城市职业学院
桂林电科大信息科技学院	桂林电子科技大学信息科技学院
望江	望江县
尖扎	尖扎县
山科大	山东科技大学	山东科大
江西大宇职院	江西大宇职业学院	江西大宇职业技术学院
宜丰	宜丰县
密支那	myitkyina
通州	通州市	通州区
云南经贸外事学院	云南经贸外事职院	云南经贸外事职业学院	云南经贸外事职业技术学院
莎娃蒂妮	salvadordali
天津生物工程职院	天津生物工程职业技术学院	天津生物工程职业学院
斯大林峰	stalinpeak
南召	南召县
鄂职大	鄂州职大	鄂州职业大学
古田	古田县
吉的堡蓝芽	青岛吉的堡蓝芽幼儿园
内江职院	内江职业技术学院	内江职业学院
格威特	gweat
2区	二区
兰开夏郡	lancashire
贾维斯岛	jarvis
电力学院	上海电力学院	长沙电力学院
武纺	武汉纺大	武汉纺织大学
金华电大	金华广播电视大学
芮城	芮城县
山贸职工大学	山东贸易职工大学	山东省贸易职工大学
超市	连锁超市	超级购物市场	超级市场	大卖场
土建院	土木建筑学院
江门职院	江门职业学院	江门职业技术学院
藁城	藁城市
江西瓷陶工艺美院	江西瓷陶工艺美术生业技术学院
沈阳职院	沈阳职业学院	沈阳职业技术学院
湾里	湾里区
秋石大	秋明国立石油天然气大学
常宁	常宁市
曲周	曲周县
北艺	北京当代艺术研修学院
阳春电大	阳春市广播电视大学
梅巴赫	迈巴赫	maybach
安宁	安宁市	安宁区
防科院	防灾科技学院
额敏	额敏县
周至	周至县
浔阳	浔阳区
珠海艺术职院	珠海艺术职业学院
福利院	社会福利院
10中	第十中学	第10中学	十中
襄阳	襄阳区	襄阳市
彭水	彭水苗族土家族自治县	彭水县	彭水自治县
满洲里机场	满洲里西郊机场	呼伦贝尔满洲里西郊机场
绥宁	绥宁县
酷派	coolpad
邯郸理工	邯郸理工学院
就业管理中心	劳动就业服务管理中心
艺卓	eizo
沙市	沙市区
河北医科大临床学院	河北医科大学临床学院
临沂职院	临沂职业学院
宁夏法警职院	宁夏法警职业学院	宁夏司法警官职业学院
黔西南民族职院	黔西南民族职业技术学院	黔西南民族职业学院
斯洛伐克	斯洛伐克共和国
昆明冶专	昆明冶金专科学校	昆明冶金高等专科学校
大和银行	daiwabank
合肥信息技术职院	合肥信息技术职业学院
上甘岭	上甘岭区
南区	南校区	南院区	南院
欧野	oyea
西河大学	西河城综合大学
门多萨	mendoza
安医大临床医学院	安徽医科大学临床医学院
八五六农航站机场	八五六农场农航站机场
磊科	netcore
西安铁路职院	西安铁路职业技术学院	西安铁路职业学院
泉州理工职院	泉州理工职业学院
安徽交通职院	安徽交通职业学院	安徽交通职业技术学院
陕西纺织服装职院	陕西纺织服装职业学院	陕西纺织服装职业技术学院
经典	精典
维亚康姆	viacom
雅江	雅江县
青岛理工大琴岛学院	青岛理工大学琴岛学院
美发店	造型店
苏州防水材料研究所	苏州非矿院防水材料研究所
海航院	烟台海军航空工程学院
贵师大	贵州师大	贵州师范学院	贵州师范大学	贵州师范	贵州师院
惠阳电大	惠阳区广播电视大学
毛家餐馆	毛家饭店
浙财	浙江财院	浙江财经	浙江财经学院	浙财院
瓦尔索尔	walsall
澳尔滨	albion
沃特伯里	waterbury
阜阳师范	阜阳师范学院	阜阳师院
纽约	newyork
蓓丽	laprairie
蚌埠	蚌埠市
前进	前进区
沽源	沽源县
山东工业职院	山东工业职业学院
雅培	abbottlaboratories
历城	历城区
咸安	咸安区
运城职院	运城职业学院	运城职业技术学院
任丘	任丘市
点军	点军区
设菲尔德	sheffield
厦门南洋职院	厦门南洋职业学院
姚安	姚安县
朔州职院	朔州职业技术学院	朔州职业学院
新德里	newdelhi
广海大	广东海洋大学
飞思卡尔	freescale
同文外语职院	山西同文外语职业学院	同文外语职业学院
cnbm	中国建筑材料集团有限公司
零陵	零陵区
南宁职院	南宁职业技术学院	南宁职业学院
平陆	平陆县
平鲁	平鲁区
武指南宁分院	武警指挥学院南宁分院	中国人民武装警察部队指挥学院南宁分院
阿尔巴尼亚	阿尔马尼亚共和国
潢川	潢川县
枣庄	枣庄市
贵财	贵财院	贵州财经	贵州财经院	贵州财经学院
山西轻工职院	山西轻工职业技术学院	山西轻工职业学院
新兴	新兴区	新兴县
西医	西安医学院
黑教院	黑龙江教育学院	黑龙江省教育学院
厨柜	橱柜
乌兰察布电大	乌兰察布广播电视大学
群大	中国群众大学
定结	定结县
摩托	摩托车
义大	义守大学
大连技师学院	大连市技师学院
娄底潇湘职院	娄底潇湘职业学院
西译	西安翻译培训学院
snda	上海盛大网络发展有限公司
田东	田东县
洛阳机场	洛阳北郊机场
经贸委	淄博经贸委	经济贸易委员会	经贸委员会	淄博市经济贸易委员会	淄博市经贸委员会	市经贸委	淄博市经贸委	淄博经贸委员会
玉龙机场	赤峰机场	赤峰玉龙机场
平罗	平罗县
加查	加查县
哈医大	哈尔滨医大	哈尔滨医科大	哈尔滨医科大学
荥阳	荥阳市
西音	西安音乐学院
平江	平江区	平江县
常州工程职院	常州工程职业学院	常州工程职业技术学院
艾美讯	amsam
斯大林诺	stalino
职工大学	胜利油田职工大学
南城	南城县
广东行政职院	广东行政职业学院
深职训	深圳职业训练学院
广工大	广东工业大学	广东工大
温莎学院	温莎商业语言学院
罗斯托夫	rostov
留尼旺岛	reunion
个旧	个旧市
泰勒	tyler
四川文理	四川文理学院
泽州	泽州县
李鹄	李鹄饼店
吐鲁番	吐鲁番地区	吐鲁番市
黎巴嫩	lebanon	黎巴嫩共和国
天主教会	天主教教会
郑大西亚斯	郑州西亚斯国际学院	郑州大学西亚斯国际学院
仁布	仁布县
马尔库斯岛	marcusisland
凡尔塞	versailles
绥化电大	绥化广播电视大学
康冠	ktc
美体考究	bodywave
泰来	泰来县
洛龙	洛龙区
首都师范外语学院	首都师范大学外国语学院
通道	通道侗族自治县	通道县	通道自治县
庆义大学	庆应义塾大学
河西	河西区
奎屯	奎屯市
博世凯学院	上海博世凯进修学院
洛林	lorraine
边坝	边坝县
云安	云安县
新斯科舍	novascotia
石台	石台县
经学院	经学学院
唐山	唐山市
海勃湾	海勃湾区
儋州	儋州市
爱国者	aigo
星巴顿	星巴顿烤鱼专家
贵州轻工职院	贵州轻工职业技术学院	贵州轻工职业学院
Saint	圣文森特和格林纳丁斯
寿宁	寿宁县
曼哈顿	manhattan
梅捷	soy
银外洋语学院	运城学院银外洋语学院
华南建筑学院	华南建筑工学院	华南建筑装饰工程学院
井冈山师院	井冈山师范学院	井冈山师范
大同电大	大同广播电视大学
西双版纳职院	西双版纳职业技术学院	西双版纳职业学院
枣庄职院	枣庄职业学院
厦门	厦门市
潮州电视台	广东省潮州市广播电视台
美体	spa
广州外语学院	广州外国语学院
水土学院	水利土木工程学院
炉霍	炉霍县
鸡冠	鸡冠区
宁大新华学院	宁夏大学新华学院
许院	许昌学院
汶川	汶川县
平湖	平湖市
协和医学院	北京协和医学院
cncec	中国化学工程股份有限公司
江西先锋软件职院	江西先锋软件职业学院	江西先锋软件职业技术学院
沈大科技工程学院	沈阳大学科技工程学院
拉果	lago
史努比	snoopy
环卫所	环境卫生管理所
瓦胡岛	oahu
石家庄联合技术职院	石家庄联合技术职业学院
北海学院	北京航空航天大学北海学院	北航北海学院
卿芳堂学院	北京卿芳堂自然疗法学院
赤壁	赤壁市
西北政法	西北政法大学
谯城	谯城区
宜宾电大	宜宾广播电视大学
东莞理工	东莞理工学院
焦大	焦作大学
国土部	中国国土资源部	国家国土资源部	国土资源部	中华人民共和国国土资源部	中华人民共和国国土部
纳维约	navajo
大马士革	damascus
东兰	东兰县
香港君悦酒店	junyuehotel
外管	外汇管理
梅江	梅江区
羊尖工业园区管理委员会	无锡市锡山区羊尖工业园区管理委员会
picc	中国人民财产保险股份有限公司
仙霞高中	上海仙霞高级中学
平和	平和县
成都纺专	成都纺织专科学校	成都纺织高等专科学校
中教大	台中教育大学
工运学院	陕西工运学院
火锅	火锅店
武警成都指挥学院	中国人民解放军武警成都指挥学院
馨慧外语	威海馨慧外语学校
茶蛋	茶叶蛋
卓尼	卓尼县
广大华软软件学院	广州大学华软软件学院
新疆农业职院	新疆农业职业学院	新疆农业职业技术学院
玉兰油	olay
大连商学院	大连商职院	大连商务学院	大连商务职业学院
东绵	tomen
绅宝	萨博	saab
南山学院	烟台南山学院
6	Ⅵ	第六	六	陆	第6	no6
安庆机场	天柱山机场	安庆天柱山机场
清镇	清镇市
东明	东明县
屏南	屏南县
烟台	烟台市
信阳农专	信阳农业专科学校	信阳农业高等专科学校
贵州电力职院	贵州电力职业学院	贵州电力职业技术学院
长理	长春理工大	长沙理工	长春理工	长沙理工大	长理大	长春理工大学	长沙理工大学
天台	天台县
晋宁	晋宁县
路胩詈	路胩詈^
宿州	宿州市
中国民科院	中国人民科学院
扎伊尔	zaire	扎伊尔共和国
江北机场	重庆机场	江北国际机场	重庆国际机场	重庆江北国际机场
汶上	汶上县
里斯本	lisbon
茶道	茶艺
亳州师专	亳州师范专科学校	亳州师范高等专科学校
衢州电大	衢州广播电视大学
武汉民政职院	武汉民政职业学院
斯图加特	stuttgart
眉山	眉山市
惠好	weyerhaeuser
凤城	凤城市
民院	民族学院	民学院
苏塞克斯	sussex
家政	钟点工	小时工
沂源	沂源县
罗切斯特	rochester
沈阳体院	沈阳体育学院
北约克郡	northyorkshire
百斯特	百思特
裕华	裕华区
杨浦	杨浦区
高碑店	高碑店市
北大远教	北大远程教育学院	北京大学远程教育学院
彭彭学校	彭彭摄影化妆学校
科协	科学技术协会	科技协会
政务大厅	行政中心大厅	行政服务中心大厅	行政审批服务中心大厅	政务审批中心大厅	政务服务中心大厅	政务中心政务大厅	政务审批大厅	行政服务大厅	政务审批服务中心大厅	行政服务中心政务大厅	政务中心大厅	行政大厅
郑州布瑞达理工职院	郑州布瑞达理工职业学院
德格	德格县
斯瓦尔巴群岛	suvalbard
信步	seavo
康尼格拉	conagra
广西职院	广西职业学院	广西职业技术学院
巴楚	巴楚县
妇儿医疗保健中心	妇女儿童医疗保健中心
山西水利职院	山西水利职业技术学院	山西水利职业学院
莱斯特	leicester
电信	中国电信
木兰	木兰县
文化馆	文化宫
长江师范	长江师院	长江师范学院
嫩江	嫩江县
随州职院	随州职业技术学院	随州职业学院
安曼	amman
覃塘	覃塘区
旅顺口	旅顺口区
滨湖	滨湖区
恩施	恩施自治州	恩施土家族苗族自治州	恩施市	恩施州
比如	比如县
漳州	漳州市
河农大	河南农业大学	河北农业大学	河北农大	河南农大
华宇职业技术学院	德州华宇职业技术学院
虹口	虹口区
黔南职院	黔南职业学院	黔南职业技术学院
彭山	彭山县
江西应用技术职院	江西应用技术职业学院
黎明工学院	沈阳黎明航空发动机(集团)有限公司工学院
霞浦一中	福建霞浦第一中学
福职院	福州职业技术学院	福州职业学院
河北经贸	河北经贸大学
克什米尔	kashmir
伊通	伊通县	伊通满族自治县	伊通自治县
安陆	安陆市
正修科大	正修科技大学
乌海	乌海市
徐州	徐州市
上海社科院	上海社会科学院
女大	女子大学
鄂尔多斯机场	伊金霍洛机场	鄂尔多斯伊金霍洛机场
汾阳	汾阳市
沙田	沙田^
科胜讯	conexant
滨海	滨海县	滨海区	滨海新区
温宿机场	阿克苏机场	阿克苏温宿机场
江医上饶分院	江西医学院上饶分院
四子王	四子王旗
青山机场	西昌机场	西昌青山机场
长江科学院	长江水利委员会长江科学院
邗江	邗江区
电脑	计算机
秀屿	秀屿区
德力西	delixi
遥墙机场	济南国际机场	济南机场	遥墙国际机场	济南遥墙国际机场
飞土学院	青岛飞土职业足艺学院
南乔治亚岛和南桑德韦奇岛
北电	nortel
都市人寿保险	metlife
淮滨	淮滨县
上海邦德职院	上海邦德职业学院	上海邦德职业技术学院
湖南商业职院	湖南商业职业学院	湖南商业职业技术学院
旧金山	sanfrancisco
湖青院	湖北青年职业学院	湖北青年学院
唐山机场	三女河机场	唐山三女河机场
垦利	垦利县
桃江	桃江县
汉阴	汉阴县
察雅	察雅县
北师大珠海分校	北京师范大学珠海分校
石大	西南石油大学	西石大	石油大学	石河子大学	中国石油大学	西南石大	中国石大	中石大	西石
珠峰	珠穆朗玛峰
机关事务处	机关事务管理处
马塞卢	maseru
玛露美	marumi
平谷	平谷区
青岛建工学院	青岛建筑工程学院
扎囊	扎囊县
突尼斯	tunisia	突尼斯共和国
秀英	秀英区
全国电大	全国广播电视大学
平果	平果县
北京希曼顿	北京希曼顿自动化研究所
杜邦	dupont
沙依巴克	沙依巴克区
劳研所	劳动卫生职业病防治研究所
天翔航院	新疆天翔航空学院
南国商学院	广外南国商学院	广东外语外贸大学南国商学院	广外南国学院	外语外贸南国商学院
尼木	尼木县
阿桑娜	azona
简阳	简阳市
桦甸	桦甸市
荆门职院	荆门职业学院	荆门职业技术学院
石经院	石家庄经济学院
内医	内蒙古医学院
深圳虚拟大学	深圳虚拟大学园
北京联大	北京联合大学
隆安	隆安县
哈理	哈理大	哈尔滨理工大学	哈尔滨理工	哈尔滨理工大
内蒙古机电职院	内蒙古机电职业技术学院	内蒙古机电职业学院
印台	印台区
沈家门三小	浙江省舟山市普陀区沈家门第三小学
西南农大	西南农业大学
水利部	中国水利部	国家水利部	中华人民共和国水利部
首山镇第二初级中学	辽宁省辽阳县首山镇第二初级中学
人社院	东北师大人文学院	人文学院	东北师范大学人文学院	东北师范人文学院	人文社会学院	人文院	人文社会科学学院
安顺机场	安顺黄果树机场	黄果树机场
新县职高	新县职业高级中学
马格达莱纳河	magdalena
海鲜	海鲜苑	海产	海鲜水产行	海鲜阁	海鲜行	海鲜村	海鲜宫	海产品	海产行	海鲜居	海鲜城	海鲜园	海鲜屋	海鲜舫	海鲜馆	海鲜港	海鲜档	海鲜楼	海产产品	海鲜坊	海鲜店
华农楚天学院	华中农大楚天学院	华中农业大学楚天学院
哈尔滨建筑学院	哈尔滨建筑工学院	哈尔滨建工学院	哈尔滨建筑工程学院
悠诗诗	悠诗诗上岛咖啡
广州市民航职院	广州市民航职业技术学院	广州市民航职业学院
解放军信息工程	解放军信息工程大学	中国人民解放军信息工程大学
连城	连城县
中文大学工商学院	香港中文大学工商管理学院
哈尔滨现代公共关系职院	哈尔滨现代公共关系职业学院
城阳	城阳区
房资局	房地资源局	房屋管理局	上海房地局	市房屋土地资源管理局	上海市房地资源管理局	上海市房地局	上海市房地资源局	房地资源管理局	房管局	上海市房屋土地资源管理局	上海房地资源管理局	市房地资源局	上海房屋土地资源管理局	市房地局	房屋土地管理局	市房地资源管理局	房屋土地资源管理局	上海房地资源局	房地局
西安师范	西安师范学院	西安师院
军经	军事经济学院	军经院	中国人民解放军军事经济学院
坊子	坊子区
西秀	西秀区
临清	临清市
湛江业大	湛江市业余大学
吉职医大	吉职医科大	吉林职工医科大学
蕲春	蕲春县
上海行健职院	上海行健职业学院
定期储蓄	定期存款
文峰	文峰区
宁洱	宁洱哈尼族彝族自治县	宁洱县	宁洱自治县
吉林农业工程职院	吉林农业工程职业技术学院	吉林农业工程职业学院
通许	通许县
法商学院	台湾省立法商学院
发那科	fanuc
吉林师范	吉林师范大学	吉林师大
坦桑尼亚	tanzania	坦桑尼亚联合共和国
和众烤吧	和众烧烤
山丹	山丹县
陆河	陆河县
北大管院	北京大学管理学院	北大管理学院
望奎	望奎县
彭湖湾	澎湖湾
广电局	广播电视局	文化广播电视管理局	广播电视管理局
桂山中学	中山市桂山中学
青海省卫生职院	青海省卫生职业学院	青海省卫生职业技术学院
涉外学院	北京涉外经济专修学院	北京涉外经济学院	北京涉外学院
宝安机场	深圳机场	宝安国际机场	深圳国际机场	深圳宝安国际机场
玉山	玉山县
湖南文理	湖南文理学院
州委	州州委会	州委员会	州委会	州州委员会	州州委
中间电大	中间广播电视大学
陆航	中国人民解放军陆军航空兵学院	陆军航空兵学院	陆航学院
保定电大	保定广播电视大学
帝盟	rio
沭阳	沭阳县
甘泉	甘泉县
职教院	广西工学院职业技术教育学院	职教学院	职业教育学院
湘阴	湘阴县
生化学院	生物化学工程学院
爱华女校	爱华国际女子学校
北航院	北华航天学院	北华航天工学院	北华航天工业学院
湖南工业职院	湖南工业职业学院	湖南工业职业技术学院
内蒙古	内蒙古自治区	内蒙古省
酉阳	酉阳土家族苗族自治县	酉阳县	酉阳自治县
福建农林大东方学院	福建农林大学东方学院
牡丹	牡丹区
墨脱	墨脱县
托莱多	toledo
米拉诺・沃德	milanoverde
上犹	上犹县
河北机电职院	河北机电职业技术学院	河北机电职业学院
人民邮电	人民邮电出版社
湖科院	湖北科技职业学院	湖北科技学院
上虞	上虞市
民办安徽文达信息技术职院	民办安徽文达信息技术职业学院
农科院	农业科学院
百事灵	buslink
纺院	纺织学院
椒江	椒江区
疏勒	疏勒县
行政学院	国家行政学院
喀士穆	khartum
商贸职院	商贸职业学院	商贸学院
密尔沃基	millwaukee
世纪学院	北京邮电大学世纪学院	北邮世纪学院
浙商大公管学院	浙江工商大学公共管理学院
外专局	中华人民共和国外专局	中国外国专家局	国家外国专家局	中华人民共和国国家外国专家局
强生国旅	强生国际旅行社
金凤	金凤区
首钢职大	首都钢铁公司职工大学
小吃部	小吃店
茂达	anapec
6中	第6中学	六中	第六中学
济洲岛	济州岛
资环院	资源环境学院
虞城	虞城县
旗美社大	旗山区旗美社区大学
湖北电大	湖北广播电视大学
武清	武清区
约翰内斯堡	johannesburg
萨莫维尔	somerville
经贸学院	云南经贸进修学院
民航运输学院	中国民用航空运输学院
联志	cpro
圣艾蒂安	saint-etienne
世贤学院	北京世贤研修学院
昆明	昆明市
航院	清华航天航空学院	清华航院	清华大学航天航空学院	航天航空学院
纽尔玛营养健康学院	上海纽尔玛营养健康管理进修学院
瓦房店	瓦房店市
广德	广德县
鸿友	mustek
长白	长白朝鲜族自治县	长白自治县	长白县
努力安	nurian
卡塔	qatar
陕西财经职院	陕西财经职业学院
特克斯	特克斯县
济宁	济宁市
继教院	继续教育学院
辽地院	辽宁地质工程学院
宁国电大	宁国广播电视大学
万山特	万山特区
闻喜	闻喜县
郯城	郯城县
闵西职院	闵西职业学院	闵西职业技术学院
伍斯特郡	worcestershire
徐水	徐水县
尤溪	尤溪县
天津师大津沽学院	天津师范大学津沽学院
广东江门艺华旅游职院	广东江门艺华旅游职业学院
神脑	senao
长汀	长汀县
嘉庚学院	厦门大学嘉庚学院	厦大嘉庚学院
韶关电大	韶关广播电视大学
车站	公车站	公交站
神木	神木县
阜新电大	阜新广播电视大学
人大附中	中国人民大学附中	人民大学附属中学	人大附属中学	中国人民大学附属中学
噶尔	噶尔县
黑河	黑河市
腾龙	tamron
江西工业工程职院	江西工业工程职业技术学院	江西工业工程职业学院
长安	长安区
武指石家庄分院	中国人民武装警察部队指挥学院石家庄分院	武警指挥学院石家庄分院
湖南司警职院	湖南司法警官职业学院	湖南司警职业学院
南浔	南浔区
法学院	法律学院	云南法学专修学院	法学学院
摩尔多瓦	摩尔多瓦共和国
石棉	石棉县
杂多	杂多县
什鲁斯伯里	shrewsbury
三门峡职院	三门峡职业学院	三门峡职业技术学院
武夷山职院	武夷山职业学院
崇川	崇川区
红星	红星区
少气院	盘城小学少儿气象科学院
辽宁师大海华学院	辽宁师范大学海华学院
恩图曼	omdurman
青岛十九中	青岛第十九中学
深国交	深圳教育国际交流学院
深物管学院	深圳物业管理进修学院
融安	融安县
浙理	浙理大	浙江理工大	浙江理工大学	浙江理工
滴道	滴道区
华南文艺学院	华南人民文学艺术学院
苏门答腊	sumatra
广州复大肿瘤医院	fudahospital
莱芜	莱芜市
綦江	綦江县
西安电大	西安广播电视大学
暹罗	siam
孝昌	孝昌县
莱西	莱西市
sina	新浪网络技术股份有限公司
篮球馆	篮球场
新东坊形象艺术	上海新东坊形象艺术培训学校
山东建材学院	山东建筑材料工业学院
工商外院	上海工商外国语职业学院
广州七中	广州市第七中学
兖州矿工大	兖州矿区职工大学	兖州矿工大学
运动技术学院	重庆市运动技术学院
鄄城	鄄城县
新汶矿工大	新汶矿工大学	新汶矿业职工大学
纳塔尔	natal
广医	广州医学院	广东医学院
黑龙江艺术职院	黑龙江艺术职业学院
圣力嘉学院	圣力嘉文理科学院
威斯康星	wisconsin
米克拉	micra
上证所	上海证交所	上交所	上海证券交易所
广药	广东药学院
森林公安专科学校	南京森林公安高等专科学校	南京森林公安专科学校
东1门	东一门
茅斯	maus
voa	美国之音
北安普顿	northampton
祥云	祥云县
九江职大	九江职业大学
黄冈师范	黄冈师院	黄冈师范学院
广州外语外贸	广州外语外贸大学
酒泉	酒泉市
海指	中国人民解放军海军指挥学院	海指学院	海军指挥学院
香格里拉	香格里拉县
胶南	胶南市
疾控	疾控中心	疾病预制中心	疾病控制中心	疾病防控中心	疾病预控中心	疾病预防控制中心	疾病防制中心	疾病预防中心
新丰	新丰县
西安邮院	西安邮电学院
鲈乡实验小学	吴江市鲈乡实验小学
阿尔山	阿尔山市
浙江尚艺	浙江尚艺美容美发学院
八一农大	八一农垦大学	黑龙江八一农垦大学
马尼托巴	manitoba
文达电脑教育	安徽文达电脑专修学院
祁阳	祁阳县
绵阳师院	绵阳师范	绵阳师范学院
永寿	永寿县
榆中	榆中县
森美兰	negrisembilan
斯托克顿	stockton
永胜	永胜县
思加讯	skyworks
皮防院	皮肤病防治院
捷特	giottos
广州松田职院	广州松田职业学院
广平	广平县
彰师大	彰化师大	彰化师范大学	彰化师范
常熟理工	常熟理工学院
苏家屯	苏家屯区
苏州港大思培科技职院	苏州港大思培科技职业学院
河师大	河北师范	河南师范大学	河北师范大学	河北师大	河南师大	河南师范
上海现代学院	上海现代文化技术培训学院
陈仓	陈仓区
黑龙江工学院昆仑旅游学院	黑龙江工程学院昆仑旅游学院
世纪艺术学校	山东世纪艺术学校
游泳池	游泳馆
天津机电职院	天津机电职业学院	天津机电职业技术学院
恒山	恒山区
贵医	贵阳医学院
浙江水专	浙江水电专科学校	浙江水利水电专科学校
凯声学院	兰州凯声学院
瑞金	瑞金市
松山	松山区
信诺	cigna
青羊	青羊区
捷豹	jaguar	美洲虎
塞尔维亚	serbia
上外贸	上海外贸学院
川中	四川中语学院
龙目岛	lombok
广外	广东外贸大学	广东外国语大学	广东外语外贸	广东外语外贸大学
陇川	陇川县
桑菱能源研究所	上海桑菱环境能源研究所
东川	东川区
江西环境工程职院	江西环境工程职业学院
交警	交通警察
三宅一生	issey	miyake	isseymiyake
聊城	聊城市
文正学院	苏大文正学院	苏州大学文正学院
施贵宝	squibb
盛泽实验幼儿园	吴江市盛泽实验小学幼儿园
牙科	口腔科
韩山师范	韩山师范学院	韩师学院
失泽艺校	失泽艺术学院
江西财经职院	江西财经职业学院
防治艾滋病工委	国务院防治艾滋病工作委员会
西电长安学院	西安电子科技大学长安学院
厦佛	厦门佛学院
新义州	sinuiju
成华	成华区
吕宋岛	luzon
湖大知行学院	湖北大学知行学院
梅列	梅列区
ctrip	携程计算机技术(上海)有限公司
衡水电大	衡水广播电视大学
哈工大华德应用学院	哈尔滨工业大学华德应用学院
东大	东北大学	东南大学
章贡	章贡区
云南社院	云南省社会主义学院
东辽	东辽县
老年大学	东华老年大学	舟山市老年大学	东华大学老年大学
天工大	天津工大	天津工业大学
中海油	中国海洋石油有限公司	cnooc	中国海油	中国海洋石油
伊藤家	itoya
东陵	东陵区
北青院	北京青年政治学院	北京政治学院
房院	上大房地产学院	房地产学院	上海大学房地产学院
石河子职院	新疆石河子职业技术学院	新疆石河子职业学院
粮食局	国家粮食局
苏联	sovietunion
腾冲	腾冲县
耐克	耐克公司	nike
安福	安福县
山财华商学院	山西财经大学华商学院
沃尔沃斯	woolworths
良庆	良庆区
桥西	桥西区
长武	长武县
豪雅	tagheuer	tag-heuer
宜秀	宜秀区
嘉陵	嘉陵区
中信实业银行	citicindustrialbank
首师大初教院	首都师范大学初等教育学院
chd	中国华电集团公司
艾利斯顿商学院	厦门艾丽斯顿商学院
辛庄中心小学	常熟市辛庄中心小学
欧塞奇河	osage
黄石	黄石市
武汉大学生命科学院	武汉大学生命科学学院
惠州经济职院	惠州经济职业学院
和布克赛尔	和布克赛尔蒙古自治县	和布克赛尔自治县	和布克赛尔县
华东革大	华东人民革命大学
鄂尔多斯职院	鄂尔多斯职业学院
宜兴	宜兴市
忘忧草网安	忘忧草网安学院
河北石油职院	河北石油职业学院	河北石油职业技术学院
河间	河间市
邢院	邢台学院
辽宁经济职院	辽宁经济职业技术学院	辽宁经济职业学院
扶风	扶风县
辽科院	辽宁科技学院
宜城	宜城市
滑冰场	溜冰场
云艺文华学院	云南艺术学院文华学院
罗德岱尔学院	北京罗德岱尔研修学院
十堰	十堰市
津市	津市市
抚州职院	抚州职业技术学院	抚州职业学院
湘院	湘南学院
绥江	绥江县
灵武	灵武市
安徽城管职院	安徽城管职业学院	安徽城市管理职业学院
文登	文登市
南边科大	南边科技大学
江大京江学院	江苏大学京江学院
云南农业职院	云南农业职业技术学院	云南农业职业学院
久久连锁	久久旅馆连锁	久久连锁旅馆	九九旅馆	99连锁旅馆	99连锁	九九旅馆连锁	九九连锁	99旅馆	九九连锁旅馆	久久旅馆	99旅馆连锁
辰溪	辰溪县
职业训练学院	深圳市职业训练学院
投促中心	投资促进中心
重庆城市管理职院	重庆城市管理职业学院
postek	深圳市博思得通信发展有限公司
源汇	源汇区
安徽林业职院	安徽林业职业技术学院	安徽林业职业学院
玛莉	玛丽
cib	china'sindustrialbank	兴业银行	兴业银行股份有限公司
平顶山	平顶山市
嘉黎	嘉黎县
工程管理局职工大学	丹江口工程管理局职工大学
设得兰群岛	shetland
石狮	石狮市
ciq	出入境检疫局	c.i.q	中国检验检疫	出入境检验检疫局	中国出入境检验检疫
印尼	印度尼西亚	indonesia	印度尼西亚共和国
徐汇区绿化管理局	上海市徐汇区绿化管理局
三明职院	三明职业学院	三明职业技术学院
衡山	衡山县
中专	中等专业学校
巫山	巫山县
山东商业职院	山东商业职业技术学院	山东商业职业学院
北京经济职院	北京经济职业技术学院	北京经济职业学院
科拉半岛	kola
安利	安利(中国)日用品有限公司	amway
上海大学预测研究所	上海大学预测咨询研究所
希格	sigg
禹王台	禹王台区
沂水	沂水县
安理	安徽理工	安徽理工大	安理大	安徽理工大学
哈职医学院	哈尔滨市职工医学院	哈尔滨职工医学院
施塔斯富特	stassfurt
市北	市北区
京海研修学院	北京京海研修学院
上海市静教院	上海市静安区教育学院
郑大护理学院	郑州大学护理学院
兰芝	laneige
吉林师大博达学院	吉林师范大学博达学院
侨办	国务院侨务办	人民政府侨务办	国务院侨办	侨务办	侨务办公室	国务院侨务办公室	政府侨务办	人民政府侨务办公室
湖南工艺美术职院	湖南工艺美术职业学院
鞍山电大	鞍山广播电视大学
黑龙江北开职院	黑龙江北开职业技术学院	黑龙江北开职业学院
广东亚视演艺职院	广东亚视演艺职业学院
泌阳	泌阳县
塞维尔	seville
札达	札达县
山西医科大晋祠学院	山西医科大学晋祠学院
长沙民政职院	长沙民政职业技术学院	长沙民政职业学院
拉贡达	lagonda
9中	第九中学	九中	第9中学
正信银行	中国正信银行	正信银行有限公司
永清	永清县
北7门	北七门
飞鹰	eagle
滕州	滕州市
行财院	四川行政财贸管理干部学院
神达	mitac
福师大	福州师范	福州师大	福州师范大学	福建师范大学	福建师范	福建师大
北语网院	北京语言大学网络教育学院
丹东	丹东市
邹平	邹平县
汇博教育	上海汇博教育进修学院
中恒	dec
固镇	固镇县
日高	nikko
凤泉	凤泉区
烟酒	烟酒行	烟酒茶	烟酒茶行
路南	路南区
玄奘	玄奘大学
岚皋	岚皋县
陕西青年职院	陕西青年职业学院
运输局	交通运输管理局	交通局	运输管理局
广西工商职院	广西工商职业技术学院	广西工商职业学院
景德镇陶院科技艺术学院	景德镇陶瓷学院科技艺术学院
广丰	广丰县
青基会	青少年发展基金会	青少年基金会
贡山	贡山县	贡山独龙族怒族自治县	贡山自治县
山东财政	山东财政学院	山财政院
辽宁	辽宁省
桐梓	桐梓县
水厂	自来水厂	矿泉水厂	矿泉水水厂	自来水水厂
湖医	湖北医学院
启智贝尔	启智贝尔潜能开发幼儿园
质检总局	国家质量监督检验检疫总局	质量监督检验检疫总局	国家质检总局
江西城市职院	江西城市职业学院
徐空院	空军学院	中国人民解放军徐州空军学院	徐州空军学院
江苏经管干学院	江苏经济干部管理学院	江苏经济管理干部学院
阿里机场	昆莎机场	阿里昆莎机场
阜阳机场	阜阳西关机场
水城	水城县
川师	四川师大	川师大	四川师范	四川师范大学
中航	中航大	民航大学	中国民航大学
平凉医专	平凉医学专科学校	平凉医学高等专科学校
秦淮	秦淮区
南医大	南京医大	南京医科大	南京医科大学
长丰学院	长丰汽车工程学院
运城机场	关公机场	运城关公机场
广发	广发行	chinaguangfabank	广发银行	guangdongdevelopmentbank	广发银行股份有限公司	cgb	广东发展银行	gdb
贵州民院人文科技学院	贵州民族学院人文科技学院
西部地区开发领导小组	国务院西部地区开发领导小组
顺庆	顺庆区
珠院	珠海学院
七台河职院	七台河职业学院
宝鸡	宝鸡市
宝玑	breguet
土耳其	turkey	土耳其共和国
北京劳动保障职院	北京劳动保障职业学院
南阳理工	南阳理工学院
cnnc	中国核工业集团公司
南华船山学院	南华大学船山学院
涪陵师范	涪陵师范学院	涪陵师院
马达兰群岛	magdalen
锡林郭勒	锡林郭勒盟	锡林郭勒市
萨特莱杰河	sutlei
武汉电大	武汉市广播电视大学
银州	银州区
棚菜	大棚菜
威尔士	wales
核工业第二研究院	核工业第二研究设计院
热农大	热带农业大学
欧舒丹	loccitane	l'occitane
桦川	桦川县
海洋馆	海洋世界
福田区企业联合协会	深圳市福田区企业联合协会
鼓楼	鼓楼区
嘉兴南洋职院	嘉兴南洋职业学院	嘉兴南洋职业技术学院
南岗	南岗区
上海建材学院	上海建筑材料工业学院
阿布扎比	abudhabi
潜江电大	潜江广播电视大学
溧水	溧水县
鸡西机场	鸡西兴凯湖机场	兴凯湖机场
纳雍	纳雍县
嘉南科大	嘉南药理科技大学
重教院	重庆教育学院
凯里	凯里市
河北民族师范	河北民族师范学院	河北民族师院
海洋国旅	海洋国际旅行社
岭医	岭南医学院
米易	米易县
乌铁局	乌鲁木齐铁路局
中山火炬职院	中山火炬职业学院	中山火炬职业技术学院
冠捷	topview
重邮	重邮大学	重庆邮电大学	重庆邮大
创业学院	内蒙古大学创业学院	内大创业学院
永仁	永仁县
计量学院现代科技学院	中国计量学院现代科技学院
信阳师院华锐学院	信阳师范学院华锐学院
安徽工业职院	安徽工业职业学院	安徽工业职业技术学院
福州警官职院	福州警官职业学院
巴南	巴南区
吕贝克	lubeck
湖艺	湖北艺术学院
京剧院	京剧剧院
马都拉岛	madura
奉贤	奉贤区
中华职院	中华职业学院	中华职业技术学院
上海科学技术职院	上海科学技术职业学院
哈尔科夫	kharkov
信阳职院	信阳职业学院	信阳职业技术学院
卡塔尔	katar	卡塔尔国
专营	专卖店	专营店	专卖
龙塔	黑龙江省广播电视塔
空政学院	空军政治学院
寺	禅寺	庙	寺庙
罗源	罗源县
中美学院	中美工商管理研修学院
潍坊新东方双语	潍坊新东方双语学校
西8门	西八门
湖北汽院	湖北汽车工业学院
长春工大人文信息学院	长春工业大学人文信息学院
天津电视研究所	天津市电视技术研究所
云社大	云林县社区大学
桂林赛雅	桂林市赛雅驾驶员培训学校
册亨	册亨县
首经贸	首都经贸大学	首都经贸	首经贸大学	首都经济贸易大学
庞迪克	pontiac
完小	完全小学
凤翔民间工艺	陕西凤翔雍城民间工艺开发研究所
武汉生物工学院	武汉生物工程学院
停车库	停车场
海师附中	海南师范大学附属中学
马尔萨拉	marsala
肥东	肥东县
包钢职工大学	包头钢铁公司职工大学	包头职工大学
韩外行	韩国外换银行	外换银行(中国)有限公司	韩外换银行	koreaexchangebank	中国韩国外换银行	外换银行	中国外换银行
亚院	亚洲友好学院
常州	常州市
影视学院	武汉影视工程学院
扬州工商外语学校	扬州工商外国语学校
大鸭梨	大鸭梨烤鸭
花垣	花垣县
桃花岛大学	桃花岛国立中央大学
河职院	河源职业学院	河源职业技术学院
汽运	长途客运汽车站	汽车客运总站	长途客运站	汽车总站	客运总站	长途汽车总站	客运中心站	汽车站	汽车运输	长途汽车站	长途客运总站	长途车站	客运站	客运中心总站	长途车总站	客运中心	汽车客运站
技展	splg
彭泽	彭泽县
秦州	秦州区
交通委	交通委员会
南宁机场	吴圩机场	南宁吴圩国际机场	吴圩国际机场	南宁国际机场
广东城建职院	广东城建职业学院
洛阳师院	洛阳师范学院	洛阳师范
札幌	sapporo
隆林	隆林各族自治县	隆林自治县	隆林县
西9门	西九门
呼中	呼中区
锡山	锡山区
建	aopen
西北9门	西北九门
联邦快递	fedex
技嘉	gigabyte
江门	江门市
淡大	淡江大学
美兰	美兰区
常州轻工职院	常州轻工职业学院	常州轻工职业技术学院
阿鲁旗	阿鲁科尔沁	阿鲁科尔沁旗
喀什师范	喀什师院	喀什师范学院
泉州市广播电视局	泉州市广播电视中心
南充外国语学校	四川省南充外国语学校
晋元高级中学	上海市晋元高级中学
西安蒙妮坦	西安蒙妮坦职业技能培训学院
山东经职院	山东经贸学院	山东经贸业学院
山西金融学院	山西金融职业学院	山西金融职院
青海畜牧职院	青海畜牧职业学院	青海畜牧职业技术学院
负	负忧
将乐	将乐县
中国直升机研究所	中国直升机设计研究所
长泰	长泰县
乌拉尔	ural
东理工	东华理工	东华理工大	东华理工学院	东华理工大学
长春理工大光电信息学院	长春理工大学光电信息学院
上蔡	上蔡县
上财	上海财经大学	西安财经学院	中财大	财经大学	上海财经	中南财大	西安财经院	西南财经	中央财经	上海财大	西南财大	西南财经大学	财大	中南财经政法	中南大	西安财经	中南财经政法大学	西财大	中南大学	西财	西财院
尼加拉瓜	尼加拉瓜共和国	nicaragua
福州科技职院	福州科技职业技术学院	福州科技职业学院
计生指导所	计划生育指导所	计划生育宣传技术指导所
剑阁	剑阁县
外科院	外国科学院
西北1门	西北一门
凉山	凉山市	凉山州	凉山彝族自治州	凉山自治州
天津开发区职院	天津开发区职业学院	天津开发区职业技术学院
迎泽	迎泽区
厦门老年大学	厦门老年大学校园
和顺	和顺县
南京交通职院	南京交通职业学院	南京交通职业技术学院
和硕	和硕县
南达科他	southdakota
彪马	puma
辛布	thimbu
铜官山	铜官山区
Sao	圣多美和普林西比民主共和国
安康职院	安康职业学院	安康职业技术学院
上海思博职院	上海思博职业技术学院	上海思博职业学院
平顶山一中	平顶山市第一中学
榕江	榕江县
柘城	柘城县
恩施职院	恩施职业学院	恩施职业技术学院
油田第六	濮阳市油田第六中学
鹤城	鹤城区
广西民族师院	广西民族师范学院	广西民族师范
安庆师范	安庆师范学院	安庆师院
万里国际中学	宁波万里国际学校中学
常德师范	常德师院	常德师范学院
建宁	建宁县
探路者	toread
新视空	seecom
景德镇专科学校	景德镇高等专科学校
阜城	阜城县
旧振南	旧振南饼店
惠州电大	惠州市广播电视大学
伊川	伊川县
中央气象台	中国气象局国家气象中心	国家气象中心	中国气象局中央气象台
汇川	汇川区
解放军	人民解放军	中国人民解放军
淄博师专	淄博师范专科学校	淄博师范高等专科学校
宣恩县第一中学	湖北省宣恩县第一中学
贝亲	pigeon
花花公子	playboy
应天职院	应天职业技术学院	应天职业学院
乡大	西安乡镇企业大学
兴庆	兴庆区
湖农大	湖南农业大学	湖南农大
青科院	青少年科学院
游戏学院	振兴院游戏人才培训学院
鸭绿江	yalu
里尔	lille
云南农机所	云南省农业机械研究所
苏大医学院	苏州大学医学院
怀化电大	怀化广播电视大学
巴库	baku
梁山	梁山县
龙嘉机场	龙家堡机场	长春龙嘉国际机场	龙家堡国际机场	长春国际机场	龙嘉国际机场	长春龙家堡国际机场	长春机场
上海建峰职院	上海建峰职业学院	上海建峰职业技术学院
丽水电大	丽水广播电视大学
扬州职大	扬州职业大学	扬州市职业大学
黄河水利职院	黄河水利职业学院	黄河水利职业技术学院
宁夏职院	宁夏职业技术学院	宁夏职业学院
水富	水富县
厕所	卫生间	wc	公共厕所wc	洗手间	公厕	公共厕所	厕所间
爱普科斯	epcos
塔城	塔城市	塔城地区
蒲城	蒲城县
宜家深圳	深圳宜家家居	深圳宜家
圣多美	saotome
鹰特	eter
拉脱维亚	latvia	拉脱维亚共和国
梵蒂冈	梵蒂冈城国
德庆	德庆县
承德旅游职院	承德旅游职业学院
上海东海职院	上海东海职业学院	上海东海职业技术学院
托斯卡纳	tuvalu
德钦	德钦县
中函院	中共中央党校函授学院	中央党校函授学院
武汉社院	武汉市社会主义学院
周日	星期日	礼拜天	星期天
美乐时	minox
塔拉纳基	taranaki
川音美院	川音美术学院	川音成都美术学院
eic学府雅思	国际英语培训专家
威尼斯	venice
福建	福建省
大庆职院	大庆职业学院
武指兰州分院	中国人民武装警察部队指挥学院兰州分院	武警指挥学院兰州分院
重庆卫生所	重庆市卫生监督所
梁园	梁园区
固原	固原市
4中	第四中学	第4中学	四中
黑龙江畜牧兽医职院	黑龙江畜牧兽医职业学院
广州珠江职院	广州珠江职业学院	广州珠江职业技术学院
通讯学院	重庆通讯学院
杰尔	ageresystem
贺兰	贺兰县
北大软件学院	北京大学软件学院
老挝	老挝人民民主共和国	laos
鹰泰	inteches	eagletech
广西民大相思湖学院	广西民族大学相思湖学院
中洋学院	江苏中洋培训学院
黄石职院	黄石职业学院	黄石职业技术学院
曲师大	曲阜师范	曲阜师范大学	曲阜师大
浙江工大浙西分校	浙江工业大学浙西分校
鹰潭	鹰潭市
常德机场	常德桃花源机场	桃花源机场
依安	依安县
绍兴	绍兴市	绍兴县
爱马仕	hermes	parfums
襄樊职院	襄樊职业学院	襄樊职业技术学院
立山	立山区
陕西国防工业职院	陕西国防工业职业技术学院	陕西国防工业职业学院
上高	上高县
安博英豪教育	安博上海英豪教育进修学院
咸丰	咸丰县
沈理	沈阳理工	沈阳理工大学	沈理大	沈阳理工大
晋城职院	晋城职业学院	晋城职业技术学院
藻江花园	常州市藻江花园幼儿园
建教学院	安徽建筑工业学院继续教育学院
黑豹	panther
华师大网院	华南师范大学网络教育学院
杜集	杜集区
药学会	药学学会
峄城	峄城区
富锦	富锦市
宝马	bmw中国	宝马bmw	bmw	宝马公司
伊春职院	伊春职业学院
罗德岛	rhodeisland
新邱	新邱区
林加延	lingayengulf
湖南外语职院	湖南外国语职业学院
班戈	班戈县
新青	新青区
南京信息职院	南京信息职业学院	南京信息职业技术学院
天理	天津理工大学	天津理工大	天理大	天津理工
新奥职院	新奥职业技术学院	新奥职业学院
管院	管理学院
龙州	龙州县
吉大	吉林大学	吉首大学
睢阳	睢阳区
委会	委员会
加蓬	加蓬共和国
成都美院	成都美术学院
摩鹿加群岛	moluccas
酿名斋	中华酿名斋
湖南财经学院	湖南财政经济学院
周口师范	周口师范学院	周口师院
政协	中国人民政治协商会议	人民政协	中国人民政协
石家庄外事学院	石家庄外事职业学院	石家庄外事职院
阜阳	阜阳市
重庆建筑工程职院	重庆建筑工程职业学院
煤炭科研究院	煤炭科学研究总院
英迪学院	英迪经贸学院
dbs	developmentbankofsingapore	星展银行	新加坡发展银行	dbsgroup
东4门	东四门
贸大近程	贸难大学近程教育学院
额济纳	额济纳旗
网师	网络师范学院
吉林体院	吉林体育学院
文水	文水县
潍坊职院	潍坊职业技术学院	潍坊职业学院
拉布拉多	labrador
河南理工大万方科技学院	河南理工大学万方科技学院
福建外经贸	福建外经贸职业学院	福建对外经济贸易学院	福建对外经济贸易职业学院
七匹狼	福建七匹狼实业股份有限公司	septwolves
西南交大公管学院	西南交通大学公共管理学院
灯塔	灯塔市
沪医	沪州医学院
海天学院	山东海天软件工程专修学院
广昌	广昌县
金寨绍新食药用菌	安徽金寨绍新食药用菌研究所
世行	wbg	世界银行	worldbankgroup
塘沽机场	天津塘沽机场
西电网络教育学院	西安电子科技大学网络教育学院
亳州职院	亳州职业学院	亳州职业技术学院
汤顿	taunton
厄瓜多尔	厄瓜多尔共和国
集大	集美大学
邳州	邳州市
北京工商专修学院	北京工商管理学院	北京工商管理专修学院
三亚城职	三亚城职院	三亚城市职业学院
雷州	雷州市
爱尔兰共和国	irishrepublic
枣阳	枣阳市
立邦漆	nipponpaint
西北8门	西北八门
佐丹奴	giodano
罗山	罗山县
天河学院	广东师范技术学院
兰州拉面	清真兰州拉面	兰州正宗牛肉拉面	清真兰州正宗牛肉拉面	兰州正宗拉面	清真兰州正宗拉面	正宗兰州牛肉拉面	清真正宗兰州牛肉拉面	兰州牛肉拉面	清真兰州牛肉拉面
武义	武义县
东吴学院	东吴职业培训学院
纽瓦克	newark
武音	武汉音乐学院
浙工大之江学院	浙江工大之江学院	浙江工业大学之江学院
吉林法警职院	吉林法警职业学院	吉林司法警官职业学院
宜宾	宜宾市	宜宾县
花溪	花溪区
科技馆	科学技术馆
肇东	肇东市
大卫杜夫	davidoff
夷陵	夷陵区
伍斯特大学	伍赛斯特大学
浙教院	浙江教育学院
秦皇岛	秦皇岛市
涪陵	涪陵区
河南检察职院	河南检察职业学院
工学院	工学学院
翔宇学院	江苏翔宇科教专修学院
伊普斯威奇	ipswich
宁波	宁波市
静香苑	静香园
莫洛凯岛	molokai
牟定	牟定县
四川邮电职院	四川邮电职业学院	四川邮电职业技术学院
外事委	外事委员会
陕西电大	陕西广播电视大学
渣\兰	teheran
肃南	肃南自治县	肃南县	肃南裕固族自治县
文法学院	中南分校文法学院
望花	望花区
湖南石油化工职院	湖南石油化工职业学院	湖南石油化工职业技术学院
希美达	ximeta
衡水	衡水市
项城	项城市
吴起	吴起县
肃宁	肃宁县
东区	东校区	东院区	东院
企大	企业大学
喀布	kabul
灵台	灵台县
ck	卡尔文克莱恩	卡尔文・克莱恩	calvinklein
石院	石油学院
温切斯特	winchester
里昂	lyons
常州信息职院	常州信息职业学院	常州信息职业技术学院
新西兰	newzealand
cd	克里斯汀・迪奥	christiandior	克里斯汀迪奥	克丽丝丁迪奥
河职医学院	河南职工医学院
荷花机场	张家界机场	张家界荷花机场
闽西职院	闽西职业学院	闽西职业技术学院
铁医	上海铁道医学院
马里	马里共和国	mali
山西经贸职院	山西经贸职业学院
梦阳工艺技术装备研究所	上海梦阳工艺技术装备研究所
呼院	呼伦贝尔学院
兰大	兰州大学
罗得西亚	rhodesia
社会群岛	societyislands
和田电大	和田广播电视大学
西安美院	西安美术学院
上沃尔特	uppervolta
大连电大	大连广播电视大学
西南交大网络学院	西南交大网络教育学院	西南交通大学网络教育学院
尼亚美	niamery
西安通信学院	解放军西安通信学院
十堰职院	十堰职业技术学院	十堰职业学院
贵州电大	贵州广播电视大学
公管学院	公共管理学院
越南	越南社会主席共和国	vietnam
萨瑟兰	sutherland
奥地利	奥地利共和国
首医大	首都医科大学	首都医科大	首都医大
药厂	制药厂	药业	制药
上戏	上海戏剧学院
亚略特	aratek
船山	船山区
宝丽莱	polaroid
长子	长子县
大连职院	大连职业技术学院	大连职业学院
西北大现代学院	西北大学现代学院
湛江海洋大学中歌艺术学院	湛江海洋大学中国歌舞团艺术学院
普宁	普宁市
精华日语学院	上海市精华日语进修学院
渝北社院	渝北区社会主义学院
同心	同心县
杂粮	粗粮	糙粮
南京晓庄	南京晓庄学院
北大外院	北京大学外国语学院	北大外国语学院
湖北财专	湖北财经高等专科学校	湖北财经专科学校
先锋软件职院	先锋软件职业学院	先锋软件职业技术学院
维尔京群岛	virginislands
泉州轻工职院	泉州轻工职业学院
南昌电大	南昌广播电视大学
东北鲁艺	东北鲁迅文艺学院
自治县委	自治县县委
山西工程职院	山西工程职业学院	山西工程职业技术学院
强生搬家	强生搬场
苏止蒇大思培科技职院	苏止蒇大思培科技职业学院
荆门机场	荆门漳河机场	漳河机场
沈师大	沈阳师大	沈阳师范大学	沈阳师范
武汉长江商学院	武汉长江工商学院
zol评测中心	中关村--评测中心
上航旅游	上海航空国际旅游
幅值裕量	幅值裕度
蓝魔	ramos
艾斯卡达	escada
墨斯文艺研究院	北京墨斯文化艺术研究院
达信	textron
士宝	spurt
化学会	化学学会
安徽财大商学院	安徽财经大学商学院
餐馆	饭庄	西餐馆	西餐	饭店	餐厅	菜馆	美食苑	饭馆
万城	msc
沧州职院	沧州职业学院	沧州职业技术学院
慧谷学院	上海慧谷创业人才专修学院
新不列颠	newbritain
安阳电大	安阳广播电视大学
上商院	上海商院	上海商学院
内蒙古边防指挥学院	内蒙古边防呼和浩特指挥学院
通山	通山县
中山网大	中山网路大学
菲律滨	philippine
华邦	winbond
菲律宾	菲律宾共和国
黔南民族医专	黔南民族医学专科学校	黔南民族医学高等专科学校
路波	lupo
鹤壁	鹤壁市
兴山	兴山区	兴山县
许昌师院	许昌师范	许昌师范学院
安阳机场	安阳北郊机场
荷兰合作银行	rabobank
桑托斯	santos
曲松	曲松县
石家庄铁大四方学院	石家庄铁道大学四方学院
中山外院	中山外国语进修学院
南师大外语学院	南师大外国语学院	南京师范大学外国语学院
广州	广州市
昂达	onda
莱马	利马	lima
临汾	临汾市
安监总局	安全生产监督管理总局	国家安全生产监督管理总局	安监管理总局	安全监管总局
慧星	彗星
信息化领导小组	国家信息化领导小组
中信银行	citic	中信银行股份有限公司	chinaciticbank
咸宁	咸宁市
松大	松花江大学
挪威	norway	挪威王国
华安	华安县
华蓥	华蓥市
青龙	青龙县	青龙满族自治县	青龙自治县
山东华宇职院	山东华宇职业学院	山东华宇职业技术学院
长治机场	长治王村机场	王村机场
整形美容	整形美容医院	整形医院
汝阳	汝阳县
意利	illy
五峰	五峰自治县	五峰县	五峰土家族自治县
禹会	禹会区
华大学院	广州市华大外语外贸专修学院
曲水	曲水县
上海政法	上海政法学院
兴才职业学院	厦门兴才职业学院	厦门兴才职业技术学院
精工	seikonpc
苏州信息职院	苏州信息职业技术学院	苏州信息职业学院
凯尔盖朗群岛	kerguelen
橘子	桔子
河北工大科信学院	河北工程大学科信学院
乌兰察布职院	乌兰察布职业学院
荆州	荆州市	荆州区
揭西	揭西县
龙沙	龙沙区
巴马	巴马瑶族自治县	巴马自治县	巴马县
潍教院	潍坊教育学院
龙山	龙山区	龙山县
王英水库管理局	湖北省王英水库管理局
寿光	寿光市
文院	文学学院	苏州少年文学院	文学院
庆安	庆安县
中洛锡安	midlothian
安徽社院	安徽社会主义学院
河医大	河北医科大学	河北医科大	河北医大
株洲职工大学	株洲市职工大学
清华经管学院	清华大学经济管理学院	清华经济管理学院
翠丰集团	kingfisher
中医大	长春中医大学	广州中医药	南京中医大学	中医大学	中国医药大学	黑龙江中医大	湖南中医药大学	福建中医药大学	辽宁中医药	成都中医药大学	山东中医药	北京中医药	成都中医药	山东中医药大学	山东中医大	辽宁中医大	湖北中医药大学	浙江中医大	湖北中医大学	北京中医大	福建中医大学	湖北中医药	安徽中医药大学	浙江中医药	湖南中医药	南京中医大	天津中医大学	上海中医大	浙江中医药大学	天津中医大	南京中医药大学	广州中医大学	长春中医大	上海中医药大学	上海中医药	湖南中医大学	中医药	南京中医药	山东中医大学	长春中医药	天津中医药	辽宁中医大学	安徽中医大学	湖北中医大	黑龙江中医药	安徽中医药	中医药大学	福建中医药	湖南中医大	福建中医大	浙江中医大学	黑龙江中医药大学	辽宁中医药大学	天津中医药大学	安徽中医大	成都中医大学	广州中医大	长春中医药大学	广州中医药大学	北京中医药大学	黑龙江中医大学	成都中医大	北京中医大学	上海中医大学
锦城学院	四川大学锦城学院	川大锦城学院	川大锦城
多芬	dove
临潼	临潼区
重庆文理	重庆文理学院
渭南师范	渭南师范学院	渭南师院
通城	通城县
安徽工程学院	安徽工程科技学院
西安医大	西安医科大学	西安医科大
石家庄信息工程职院	石家庄信息工程职业学院
金士泰	kingstekgem
抻面	拉面
安徽工商学院	安徽工商职业学院	安徽工商职院
阿勒泰	阿勒泰市	阿勒泰地区
马克思主义培养学院	浙大青年马克思主义者培养学院	浙江大学青年马克思主义者培养学院	浙大马克思主义培养学院	青年马克思主义者培养学院
宝鸡职院	宝鸡职业技术学院	宝鸡职业学院
伊万诺沃	ivanovo
岭院	岭南学院	广东岭南学院
孝南	孝南区
育才学院	西南大育才学院	西南大学育才学院	育才专修学院
隆德	隆德县
揭阳	揭阳市
京斯峰	kingspeak
顺德	顺德区
平房	平房区
重庆冶成院	重庆冶金成人学院
钦州二中	广西钦州市第二中学
川音	四川音乐	四川音乐学院
芜湖职院	芜湖职业技术学院	芜湖职业学院
南方医大	南方医科大学	南方医科大
武宁	武宁县
湘攸大碗菜	湘攸农家大碗菜馆	湘攸陈家大碗菜
吉大张家界学院	吉首大学张家界学院
黑龙江幼儿师专	黑龙江幼儿师范高等专科学校	黑龙江幼师专科学校
东北人饺子	东北人饺子坊	东北饺子馆	东北饺子坊	东北人饺子馆
明尼阿波利斯	minneapolis
波罗	polo
哈尔滨外语学院	哈尔滨外国语学院
维苏威火山	vesuvius
乐平	乐平市
元坝	元坝区
麦欣学院	上海市麦欣进修学院
连云	连云区
利伯维尔	libreville
军艺	军艺术学院
拖拉机学院	第一拖拉机制造厂拖拉机学院
维健美	guinot
克拉玛依职院	克拉玛依职业学院	克拉玛依职业技术学院
合院	合肥学院
川页	川页瘦身
马克萨斯群岛	marguesasislands
江汉艺职	江汉艺术职业学院	江汉艺术职院
湛江坡头机场	湛江坡头直升机场
中成学院	广州中成软件技术培训学院
新昌中学	浙江新昌中学
阿城	阿城区
帕尔巴特山	nangaparbat
湖南信息职院	湖南信息职业技术学院	湖南信息职业学院
思南	思南县
衡阳电大	衡阳市广播电视大学
鄂东职院	鄂东职业学院	鄂东职业技术学院
合肥通用职院	合肥通用职业学院	合肥通用职业技术学院
惠东电大	惠东县广播电视大学
人大出版社	中国人民大学出版社
南京职院	南京职业技术学院	南京职业学院
山城	山城区
剑河	剑河县
威世	vishay
宕昌	宕昌县
央视	中央电视台	中国中央电视台	cctv
五家渠	五家渠市
居巢	居巢区
上海业余工大	上海市业余工业大学
榕城	榕城区
馆陶	馆陶县
阳高	阳高县
戏剧学院	吉林艺术学院戏剧学院
中井院	中国井冈山干部学院
达拉特	达拉特旗
中新社	中国新闻社
安康经贸学院	安康经贸管理专修学院
cnnic	中国互联网络信息中心	互联网络信息中心
方城	方城县
主修学院	主修专业学院
杭州市环科院	杭州市环境科学院
滨院	滨州学院
简阳中学	四川省简阳中学
杏林学院	中医大杏林学院	辽宁中医大学杏林学院	中医药大学杏林学院	辽宁中医大杏林学院	辽宁中医药大学杏林学院	中医药杏林学院	中医大学杏林学院	南通大学杏林学院	辽宁中医药杏林学院
华星影城	华星国际影城
塔马塔夫	tamatave
猪流感	甲型h1n1
广教院	广西教育学院	广东教育学院
徕卡	leica
赣西科技职院	赣西科技职业学院
柘荣	柘荣县
景泰	景泰县
合肥经济技术职院	合肥经济技术职业学院
社院	社会主义学院
迈锡尼	mycenae
威盛	via
长寿	长寿区
无锡市商业职院	无锡市商业职业学院	无锡市商业职业技术学院
喀什机场	新疆喀什机场
临澧共大	临澧县共产主义劳动大学
85度	85度c咖啡蛋糕烘焙	85度c	85°	85°c
长沙中山外语学院	长沙中山外国语学院
萧山八中	杭州市萧山区第八高级中学
惠来	惠来县
江教院	江苏教育学院	江西教育学院
乐业	乐业县
锡拉丘兹	syracuse
上海东沪职院	上海东沪职业技术学院	上海东沪职业学院
武宣	武宣县
纳尔逊	nelson
渝大	渝洲大学
陕西科大镐京学院	陕西科技大学镐京学院
哈巴河	哈巴河县
海东	海东市	海东地区
饶河	饶河县
江汉	江汉区
特立尼达和多巴哥	特立尼达和多巴哥共和国
铭u	迅影铭u	maxsun
白云职院	白云职业学院	白云职业技术学院
天河	天河区
斯里兰卡	srilanka	斯里兰卡民主社会主义共和国
赛罕	赛罕区
香港体院	香港体育学院
江海	江海区
奥斯陆	oslo
宁安	宁安市
展望学院	上海市展望发展学院	上海展望发展进修学院
海尔	海尔集团	海尔商城	haier
黄岛	黄岛区
imti	英泰移动通信学院
丹阳	丹阳市
甘谷	甘谷县
延安机场	二十里铺机场	延安二十里铺机场	二十里堡机场
下财浙院	下海财经小学浙江学院
供销合作社	安徽供销合作社	安徽省供销合作社联合社
南邮通达学院	南京邮电大学通达学院
水电三局	中国水利水电第三工程局	中国水电三局
山西林业职院	山西林业职业技术学院	山西林业职业学院
淮阳	淮阳县
东方研修学院	北京东方研修学院
灵石	灵石县
伊索	aesop
悠莱	urara
宁夏电大	宁夏广播电视大学
德阳安琪儿幼儿园	德阳安琪儿双语幼儿园
烟台教育学院	烟台教育学院烟台电视大学
麻栗坡	麻栗坡县
浙大	浙江大学
太白	太白县
周五	礼拜五	星期五
江西社院	江西省社会主义学院
斯威士兰	斯威士兰王国	swaziland
新疆电大	新疆广播电视大学
沾化	沾化县
昆明理工津桥学院	昆明理工大学津桥学院
乡镇企业局	乡镇企业管理局
秀山	秀山土家族苗族自治县	秀山县	秀山自治县
广州科贸职院	广州科贸学院	广州科技贸易学院	广州科技贸易职业学院
麦纳麦	manama
湖北	湖北省
民丰	民丰县
贸大	贸易大学
广元	广元市
镇赉	镇赉县
淮安	淮安市
浙传	浙江传媒	浙江传媒学院
广元机场	盘龙机场	广元盘龙机场
安泰	aetna
圣达特	cendant
大连软件职院	大连软件职业学院
烤鱼	烤全鱼
湖滨	湖滨区
佳职院	佳木斯职院	佳木斯职业学院
欧宝可赛	欧宝corsa
重庆移通学院	重庆邮电移通学院
沙伦	sharon
东莞南博职院	东莞南博职业学院	东莞南博职业技术学院
丰田	toyota	toyotamotor
长虹	长虹集团	changhong
公交	公车	公交车
辽宁商职院	辽宁商贸职业学院	辽宁商贸学院	辽宁商学院
广东财职院	广东财经学院	广东财经职业学院
塞浦路斯	cyprus	塞浦路斯共和国
武汉邮电专修学院	武汉邮电信息专修学院
布隆迪	布隆迪共和国
叙利亚	syria	阿拉伯叙利亚共和国
萍乡电大	萍乡广播电视大学
沈大新民师范	沈阳大学新民师范学院
湖南理工	湖南理工学院
大连翻院	大连翻译职业学院	大连翻译学院
嘉县社大	嘉义县社区大学
北京易通电	北京易通电加工技术研究所
墨西塞德	merseyside
四川警院	四川警察学院
珠海外经贸	珠海外经贸专修学院	珠海市外经贸专修学院
温大瓯江学院	温州大学瓯江学院
西建院	西安建设科技学院
金平	金平自治县	金平区	金平苗族瑶族傣族自治县	金平县
易门	易门县
nkk	日本钢管
台州机场	黄岩路桥机场	黄岩机场	路桥机场	台州路桥机场
北9门	北九门
罗定职院	罗定职业学院	罗定职业技术学院
西安海棠职院	西安海棠职业学院
罗家机场	景德镇罗家机场	景德镇机场
海南经贸职院	海南经贸职业学院
大庆医专	大庆医学专科学校	大庆医学高等专科学校
柯尔库布里郡	kirkcudbrightshire
山青政	山东青年政治学院
母婴乐	广州母婴乐妇儿用品店
汉沽区第一幼儿园	天津市汉沽区第一幼儿园
同济网院	同济大学网络教育学院	同济网络教育学院	同济网络学院
兰博	lampo
工商电大	河南省工商行政管理广播电视大学
米地	midi
索创	socany
福清	福清市
ual	美国联合航空	联合航空
佳木斯机场	佳木斯东郊机场
布加迪	bugatti
郑州经贸职院	郑州经贸职业学院
uae	阿拉伯联合酋l国	阿拉伯联合酋长国	阿联酋	阿拉伯联合酋闸国
内江电大	内江广播电视大学
克莉丝汀	克莉斯汀
茳西电大	茳西广播电视大学
黄龙机场	九寨机场	九寨沟黄龙机场	九黄机场	九寨沟机场	九寨黄龙机场
奥克兰	oakland	奥克兰大
玉溪	玉溪市
洪山	洪山区
邯郸电大	邯郸广播电视大学
文山	文山自治州	文山壮族苗族自治州	文山市	文山州	文山县
合肥	合肥市
和平医学院	石家庄和平医学院
会理	会理县
若尔盖	若尔盖县
柏恒	paccom
威刚	adata
大连机场	大连周水子国际机场	大连国际机场	周水子国际机场	周水子机场
广东燃气协会	广东省燃气协会
内蒙古商贸职院	内蒙古商贸职业学院
自助	自助餐
艾尔莎	elsa
卡特彼勒	caterpillar
百色	百色市
东北人	东北人家
威根	wigan
北京动物卫生所	北京市动物卫生监督所
国武学院	上海国际武术学院
西3门	西三门
奥克利	oakley
郑州工业安全职院	郑州工业安全职业学院
湖北师院	湖北师范	湖北师范学院
北科经管学院	北科经济管理学院	北京科技大学经济管理学院
公共关系进修学院	中华公共关系进修学院
雅茅斯	yarmouth
动科院	动物科学技术学院
神州医科院	神州医学科学院
桂林航专	桂林航天工业专科学校	桂林航天工业高等专科学校
国际关系	国际关系学院	北京大学国际关系学院	关系学院	北大国际关系学院
海市蜃楼	mirage
厦门城市职院	厦门城市职业学院
西数	西安数字技术学院
康踏	kangta
西工院	西安工程兵工程学院
九江	九江市	九江县
湖州	湖州市
宝坻	宝坻区
绥德	绥德县
盱眙	盱眙县
湖州师范求真学院	湖州师范学院求真学院
澳门	澳门特别行政区
使命召唤	callofduty
南昌理工	南昌理工学院
中国测绘研究院	中国测绘科学研究院
新津	新津县
米脂	米脂县
斯坦福	stamford
汉高	henkel
永泰	永泰县
中欧商学院	中欧国际工商学院
周三	星期三	礼拜三
康保	康保县
团中央	中国共产主义青年团中央委员会	青年团中央委员会
临猗	临猗县
二军大	解放军第二军医大学	中国人民解放军第二军医大学	第二军医大学
华西医大	四川华西医科大学	华西医科大
德清	德清县
湘厨	湘厨餐厅
仁和	仁和区
河工院	河南工学院	河北工程学院	河北工学院	河南工程学院
沈家门第二小学	浙江省舟山市沈家门第二小学
桓仁	桓仁自治县	桓仁县	桓仁满族自治县
国际室内设计协会	国际室内装饰设计协会
莱索托	lesotho	莱索托王国
上海立信会计	上海立信会计学院
北航法学院	北京航空航天大学法学院
福州外语学校	福州外国语学校
水电七局	中国水利水电第七工程局	中国水电七局
搜狐公司	sohu
徐州机场	观音机场	徐州观音机场
郑粮院	郑州粮食学院
运城师范	运城师范学院	运城师院
汽车科技学院	湖北汽车工业学院科技学院
国企	国有企业
新生中心小学	江苏省兴化市新生中心小学
新郑机场	郑州新郑国际机场	郑州国际机场	郑州机场	新郑国际机场
成气院	成都气象学院
信阳师院	信阳师范	信阳师范学院
卓达大学	北京卓达大学
成医	成都医学院
列宾美院	列宾美术学院
丽人阁	温州丽人阁
安万特	aventis	安内特
马拉尼翁	maranon
列克星敦	lexington
维客	vicoinn
任城	任城区
反贪局	反贪污贿赂局	人民检察院反贪污贿赂局	反贪污局
二极管	两极管
大东	大东区
承医	承德医学院
嘉职院	嘉兴职业技术学院	嘉兴职业学院
白玉	白玉县
岭大	岭南大学
辽宁现代服务职院	辽宁现代服务职业学院	辽宁现代服务职业技术学院
软件学院	软件职业技术学院
明基	benq	明基电通信息技术有限公司
沈阳职院城市学院	沈阳职业技术学院城市学院	沈阳职业学院城市学院
乌兰巴托	ulanbator
北航经管学院	北航经济管理学院	北京航空航天大学经济管理学院
武汉工程职院	武汉工程职业技术学院	武汉工程职业学院
万柏林	万柏林区
吉木萨尔	吉木萨尔县
团风	团风县
利盟	lexmark
楚雄师院	楚雄师范学院	楚雄师范
建邺	建邺区
赣南师范	赣南师范学院	赣南师院
粤港驾校	粤港学车
空管学院	空中交通管理学院
七天	7天快捷	7天快捷酒店	柒天连锁快捷酒店	柒天连锁	7天连锁快捷酒店	七天快捷	柒天快捷连锁酒店	七天连锁酒店	柒天连锁酒店	七天快捷酒店	7天连锁酒店	柒天快捷酒店	7天快捷连锁酒店	柒天快捷	柒天酒店	7天	七天连锁快捷酒店	7天酒店	七天连锁	七天快捷连锁酒店	七天酒店	7天连锁	柒天
杰思慕	jessimode
千卉瑜伽	千卉速瘦瑜伽国际联盟学院
黑龙江生物科技职院	黑龙江生物科技职业学院
沧州医专	沧州医学专科学校	沧州医学高等专科学校
萨莫色雷斯岛	samothrace
布拖	布拖县
三叶草	阿迪达斯	adidas
电力机械制造公司机电学院	西安电力机械制造公司机电学院
海阳	海阳市
山东工管干	山东省工会管理干部学院	山东工管干学院
石河子	石河子市
华师附中新世界学校	广州市白云区华师附中新世界学校
阿尔法	alpha	阿尔发
体彩	体育彩票	中国体育彩票
新艺院	新疆艺术学院
海盐	海盐县
伍尔弗汉普顿	wolverhampton
外院	外语学院	外国语学院
大洋洲	oceania
塔兰托	taranto
剑川	剑川县
麦加	mecca
国管局	国务院机关事务管理局	机关事务管理局	机关事务局
华一银行	firstsinobank
山理	山东理工	山理大	山东理工大	山东理工大学
拉各斯	lagos
抚州电大	抚州广播电视大学
三峡职院	三峡职业技术学院	三峡职业学院
三医大	第三军医大	三军医大学	第三军医大学	三军医大
营口	营口市
香港浸会大学联合国际学院	北京师范大学香港浸会大学联合国际学院
西安野马计算机培训学校	陕西计算机学会西安野马计算机培训学校
陆地巡洋舰司	landcruiser
丰都	丰都县
霸州	霸州市
县委	县委员会	县委会	县县委	县县委会	县县委员会
清山秀水	青山秀水
紫云	紫云苗族布依族自治县	紫云县	紫云自治县
北区	北校区	北院区	北院
茂名电大	茂名广播电视大学
南京审院	南京审计学院
广饶	广饶县
鹤峰	鹤峰县
罗江	罗江县
阆中	阆中市
绥阳	绥阳县
山东畜牧兽医职院	山东畜牧兽医职业学院
双塔	双塔区
辽宁广告职院	辽宁广告职业学院
五指山	五指山市
邕宁	邕宁区
抚顺职院	抚顺职业技术学院	抚顺职业学院
三峡联合职大	三峡联合职业大学
信阳电大	信阳广播电视大学
台大医学院	台湾大学医学院
沈工院	沈阳工程学院	沈阳工学院
世界电讯	worldcom
斗牛士	matador
广西水利电力职院	广西水利电力职业技术学院	广西水利电力职业学院
深交所	深圳证券交易所	深证所	深圳证交所
中华艺大	中华艺术大学
香山机场	中卫香山机场	中卫机场
南亚	elixir
武汉大学外语学院	武汉大学外国语言文学学院
九江电大	九江广播电视大学
矿大	徐州矿业大学	徐州矿大	中国矿大	徐州中国矿业大学	矿业大学	中国矿业大学
苏州农业职院	苏州农业职业学院	苏州农业职业技术学院
皮特凯恩群岛	皮竺凯恩群岛
西经大	西城经济科学大学
苏州电大	苏州广播电视大学
亚公大	亚洲(澳门)国际公开大学
花卉市场	花卉交易市场
沃尔瑟姆	waltham
天大软件学院	天津市大学软件学院
博罗	博罗县
华美英语实验学校	广州市华美英语实验学校
迪卡侬	decathlon
内蒙古化工职院	内蒙古化工职业技术学院	内蒙古化工职业学院
南阳	南阳市
曳屋	coco曳屋	一番屋	coco一番屋
贡井	贡井区
贵州警察职院	人民警察职业技术学院	贵州人民警察职业技术学院
天祝	天祝自治县	天祝县	天祝藏族自治县
江西工业职院	江西工业职业技术学院	江西工业职业学院
青岛	青岛市
安奈特	ati
资阳	资阳市	资阳区
南昌航空大学科技学院	南昌航空航天大学科技学院
长大莱佛士	长春大学莱佛士国际学院
峡江	峡江县
重庆信息技术职院	重庆信息技术职业学院
男爵	lebaron
黑龙江农业职院	黑龙江农业职业技术学院	黑龙江农业职业学院
巨人学校	巨人教育	北京巨人学校
彭阳	彭阳县
土人设计	北京土人景观与建筑规划设计研究院	土人设计研究院
凤台	凤台县
四川省工程职院	四川省工程职业学院	四川省工程职业技术学院
黔南民族职院	黔南民族职业技术学院	黔南民族职业学院
贡觉	贡觉县
东大秦皇岛分校	东北大学秦皇岛分校
清华管院	清华管理学院	清华大学管理学院
天津工程职院	天津工程职业学院	天津工程职业技术学院
墨竹工卡	墨竹工卡县
蒙特爱迪生	montedison
ems	中国邮政集团公司
瓮安	瓮安县
雷卡	lecar
第一医学院	第一临床医学院
萝北	萝北县
丽职院	丽水职业学院	丽水职业技术学院
加格达奇	加格达奇区
金伯利	kimberley
加月都	katmandu
太原市住房公积金	太原市住房公积金管理中心
话吧	ip电话超市	ip电话	公用电话	ip电话亭	公用电话亭	公共电话	公共电话亭
厦门华天涉外职院	厦门华天涉外职业学院	厦门华天涉外职业技术学院
银海	银海区
交大金融学院	交大高级金融学院	上海交通大学上海高级金融学院
光宝	liteon
牡丹江一中	牡丹江第一高级中学
桂林	桂林市
塞纳河	seine
柯棣华专修学院	石家庄柯棣华医学专修学院
燕之屋	燕之屋燕窝连锁机构
天府学院	西南财大天府学院	西南财经大学天府学院
河北师大汇华学院	河北师范大学汇华学院
香港蛋仔	香港qq蛋仔
山东外语职院	山东外国语职业学院	山东外语职业学院
临海	临海市
汉寿	汉寿县
花旗银行	itibank	citibank
精神病院	精神病医院
诺曼底	normandy
荔蒲	荔蒲县
新民	新民市
临河	临河区
鱼钩	渔钩
惠灵顿	wellington
波兰	波兰共和国
江苏机管干	江苏机管干学院	江苏省省级机关管理干部学院	江苏机关管理干部学院
科技教育领导小组	国家科技教育领导小组
加丹加	katanga
新密	新密市
北京交通职院	北京交通职业学院	北京交通职业技术学院
西安翻院	西安翻译学院
天宁	天宁区
新闻办	国务院新闻办	国务院新闻办公室
陕西服装艺术职院	陕西服装艺术职业学院
洛阳电大	洛阳广播电视大学
北山街道办	杭州西湖区北山街道办事处
四军大	解放军第四军医大学	第四军医大学	中国人民解放军第四军医大学
贵州电子信息职院	贵州电子信息职业技术学院	贵州电子信息职业学院
天师附小	天水师范学校附属小学
藏医院	藏医医院
马村	马村区
九龙坡	九龙坡区
辽宁外经贸	辽宁对外经贸学院	辽宁外经贸学院
越剧院	越剧剧院
机电职院	机电职业学院
职中	职业中学
成都医护学院	成都大学医护学院
天龙学院	大连天龙计算机专修学院
虹桥机场	虹桥国际机场	上海虹桥国际机场
湖南杂交水稻研究中心	国家杂交水稻工程技术研究中心
巴啦啦	巴拉拉
北教大	台北教育大学
山东凯文学院	山东凯文技术学院
歌舞团	文工团
瓦伦蒂诺	valentino
溧阳	溧阳市
硕菁	soking
蜀山	蜀山区
西	西^
暨大	暨南大学
福山	福山区
新墨西哥	newmexicc
刚察	刚察县
高平	高平市
澄迈县
磐安	磐安县
高坪	高坪区
玉林	玉林市
树德科大	树德科技大学
节水办	节约用水办公室
广东科贸学院	广东科贸职业学院	广东科贸职院
沧州	沧州市
哈师大	哈尔滨师范大学	哈尔滨师范	哈尔滨师大
涞水	涞水县
瑞萨	renesas
武指济南分院	武警指挥学院济南分院	中国人民武装警察部队指挥学院济南分院
山东协和职院	山东协和职业学院	山东协和职业技术学院
平远	平远县
黑龙江农垦林业职院	黑龙江农垦林业职业学院	黑龙江农垦林业职业技术学院
八道江	八道江区
东5门	东五门
辽宁科大信息技术学院	辽宁科技大学信息技术学院
三洋	sanyo
点睛网	点睛网络律师学院
人口学院	南京人口学院
娜亚	noah
南通农业职院	南通农业职业学院	南通农业职业技术学院
房屋	房子
夏葛医大	夏葛医科大学	夏葛医科大
安盛	axa
江苏城市职院	江苏城市职业学院
青草湖社大	新竹市青草湖社区大学
戚墅堰	戚墅堰区
津南	津南区
梅瑟蒂德菲尔	merthyrtydfill
北海艺术学院	北海艺术设计职业学院
三亚	三亚市
库车	库车县	kuqa
上海医疗器械专科学校	上海医疗器械高等专科学校
武指	武警指挥学院	中国人民武装警察部队指挥学院
韶关	韶关市
合肥电大	合肥广播电视大学
海大	中国海洋大学	大连海事大学	海洋大学	大连海大	上海海事大学	中国海大	中海大	海南大学	海事大学
狼爪	jackwolfskin
嘉兴电大	嘉兴广播电视大学
上海人大人学院	上海人大人继续教育进修学院
思政学院	思想政治教育学院
禄丰	禄丰县
江干	江干区
斯里巴加湾	bandarseribegawan
廊坊	廊坊市
伦敦	london
扬州税院	税务总局扬州税务进修学院
人保	中国人民保险	人民保险	中国人保
江西当代职院	江西当代职业学院	江西当代职业技术学院
培商	培正商院	培正商学院
锦屏	锦屏县
龙湖	龙湖区
伊泰莲娜	italina
延平	延平区
都江堰	都江堰市
灞桥	灞桥区
医院	附属医院	中心医院	人民医院	附院
中工院信息商务学院	中原工学院信息商务学院
垫江	垫江县
华科武昌分校	华中科技大学武昌分校
温州电大	温州广播电视大学
芳草花艺插花培训	南京芳草花艺插花培训中心
复仁进修学院	上海市复仁进修学院
济大泉城学院	济南大学泉城学院
英吉沙	英吉沙县
大安	大安市	大安区
闽院	闽江学院
俄克拉何马	oklahoma
玖熙	ninewest
奥利多	奥利多特色小吃
龙海	龙海市
萧邦	chopard
西南交大科技学院	西南交通大学科技学院
漯河	漯河市
慕尼黑	munich
河市机场	达州河市机场	达州机场
特拉维夫	telaviv
黑莓	blackberry
科龙	kelon
南信大	南京信息工程大学	南京信息大学
东3门	东三门
金鹏	jinpeng
西固	西固区
国家留学基金管委会	国家留学基金管理委员会	中国国家留学基金管理委员会
仁爱学院	天津大学仁爱学院	天大仁爱学院
北洋学院	天津市北洋涉外专修学院
长葛	长葛市
齐鲁音乐艺术学院	北京齐鲁音乐艺术学院
韶大医学院	韶关学院医学院
武工大	武汉工程大学	武汉工大
沁阳	沁阳市
贵州箩箩	贵州锣锣
明溪	明溪县
延边	延边自治州	延边朝鲜族自治州	延边市	延边州
湖科大	湖南科大	湖南科技大学
烟大	烟台大学
斯普林特	sprint
金浪	kingnet
镇安	镇安县
几内亚比绍	几内亚比绍共和国
哈萨克	kazaksatan	哈萨克族
果洛	果洛自治州	果洛藏族自治州	果洛州	果洛市
甘井子	甘井子区
泗水	泗水县
省直电大	河南省直广播电视大学
张掖医专	张掖医学专科学校	张掖医学高等专科学校
靓妃	liangfei
普诚科技	princeton
普兰	普兰县
颍上	颍上县
萨拉戈萨	saragossa
镇巴	镇巴县
肯高	kenko
女子短大	女子短期大学
纽曼	newsmy
朔州双语学校	朔州市双语学校
电资学院	电机资讯学院
泰山航海职院	泰山航海职业学院
沈飞工学院	沈阳飞机工业(集团)有限公司工学院
大兴励进	大兴励进企业管理学院
黄花机场	长沙国际机场	黄花国际机场	长沙黄花国际机场	长沙机场
中国证券操盘学院	中国证券职业操盘网络学院
江西艺职	江西艺术职业学院	江西艺术职院
娇兰	娇兰佳人	guerlain
舞炫学院	舞炫国际健身培训学院
西南网院	西南大学网络学院	西南大学网络教育学院	西南网络大学
睢宁	睢宁县
武汉警官职院	武汉警官职业学院
办	办事处	办公室
银川学院	矿大银川学院	矿业大学银川学院	中国矿大银川学院	中国矿业大学银川学院
土特产	土特产品	土特产产品
傅记	傅记咖啡
全面具到	全面俱到
5中	第五中学	第5中学	五中
夷陵机关幼儿园	宜昌市夷陵区机关幼儿园
大房身机场	长春大房身机场
金乡	金乡县
上海金程	上海金程国际金融专修学院
金安	金安区
湖南外经贸	湖南对外经济贸易职业学院	湖南对外经济贸易学院	湖南外经贸学院
白河	白河县
锦州师范	锦州师范学院	锦州师院
长治医学院	山西长治医学院
屏东师院	屏东师范	屏东师范学院
翔升	pcasl
宣武	宣武区
江苏技师	江苏技术师范学院	江苏技术师范
祁连	祁连县
龙华机场	上海龙华机场
辽宁食品药品检验所	辽宁省食品药品检验所
福建卫生职院	福建卫生职业技术学院	福建卫生职业学院
村委	村村民委员会	村村委会	村民委员会	村村委员会	村委会	村村委	村委员会
岢岚	岢岚县
泰州	泰州市
华龙	华龙区
沈阳航空学院就用技术研究所	沈阳航空工业学院应用技术研究所
大渡口	大渡口区
浙商大	浙江工商大学
卫神	卫理神学院
福建警院	福建警察学院
巴西	巴西联邦共和国
辣麻香锅	辣麻香香锅	麻辣香锅
重庆江津职院	重庆江津职业学院
德士古	texaco
长沙职院	长沙职业技术学院	长沙职业学院
学院	交大学院	上海交通大学学院
厄立特里亚	厄立特里亚国
农产品	农产产品
西铁城	citizen
永康	永康市
富蕴	富蕴县
驿城	驿城区
龙亭	龙亭区
隆尧	隆尧县
德奥达	德奥达会馆
美日通培训学校	合肥美日通培训学校
榆林机场	榆阳机场	榆林榆阳机场
平煤职大	平顶山煤矿职工大学
西洛锡安	westlothian
印度	印度共和国	india
上海行知学院	上海行知职业技术进修学院
中大南方学院	中山大学南方学院
洛川	洛川县
宾川	宾川县
新艺学院	洛阳新艺影艺专修学院
瑞典	sweden	瑞典王国
街道办	街道办事处
丽堤	丽堤汽车旅馆
中	初中	附属中学	初级中学	附中	中学	中学校
龙湾	龙湾区
密山	密山市
河北联大轻工学院	河北联合大学轻工学院
州	洲
富裕	富裕县
交大管院	西安交大管理学院
雪狼	snowwolf
定远	定远县
奥林匹克岛	olympicpeninsula
爱尔兰岛	ireland
特检院	特种设备检测院
富源	富源县
体科院	体育科学院	体育科学学院
新侨	瑞莱新侨	新侨面包	新侨饼屋
创新学院	上海市创新文化科技进修学院
重庆电子科技职院	重庆电子科技职业学院
陕西电子科技职院	陕西电子科技职业学院
科工委	中华人民共和国国防科学技术工业委员会	国防科学技术工业委员会	国防科工委
鱼峰	鱼峰区
喀拉昆仑山脉	karakoramrange
安哥拉	安哥拉共和国
蓬安	蓬安县
犹他	utah
拉萨师专	拉萨师范高等专科学校	拉萨师范专科学校
新林	新林区
门源	门源自治县	门源回族自治县	门源县
汉南	汉南区
西双版纳社院	西双版纳州社会主义学院
贸大长途	贸易大学长途教诲学院
禁毒委	禁毒委员会
长大旅游学院	长春大学旅游学院
电子职大	南京电子工业职工大学
瓦伦西亚	valencia
武汉冶管干	武汉冶金管理干部学院	武汉冶管干学院
人大本科招生办	中国人民大学本科招生办公室
缤特力	plantronics
定军山初级中学	勉县定军山镇初级中学
新龙	新龙县
莆院	莆田学院
丹东师专	丹东师范专科学校
山西医科大汾阳学院	山西医科大学汾阳学院
爱威亚	avia
大地文化进修学院	上海市大地文化进修学院
畜产品	畜产产品
庐陵学院	庐陵专修学院
辽河石油职院	辽河石油职业学院	辽河石油职业技术学院
斯特拉斯堡	strasbourg
奥体中心	奥林匹克体育中心
大足	大足县
同济浙江学院	同济大学浙江学院
温布尔登	wimbledon
立陶宛	立陶宛共和国
会昌	会昌县
西域饭庄	西域美食	西域食府
厦门大学网络学院	厦门大学网络教育学院
柳林	柳林县
翔飞化学	南京翔飞化学研究所
斯卡帕湾	scapaflow
和龙	和龙市
窝头	窝窝头
nortek	挪威nortekas公司
科左后旗	科尔沁左翼后	科尔沁左翼后旗
教育部	中华人民共和国教育部	中国教育部	国家教育部
2中	第2中学	二中	第二中学
外汇局	国家外汇管理局	外汇管理局
云南热带作物职院	云南热带作物职业学院
广西经济职院	广西经济职业学院
科技	科学技术
丹江口	丹江口市
培训学校	培训教学
西南师大	西南师范	西南师范大学
西南联大	昆明西南联合大学	西南联合大学	昆明西南联大
淮师	淮北师大	淮北师范	淮北师范大学
华南农大珠江学院	华南农业大学珠江学院
爪哇	java
美体小铺	thebodyshop
博雅医学整形	潍坊博雅医学整形美容研究所
叠彩	叠彩区
时装学院	时装艺术学院	国际时装艺术学院
武指拉萨分院	武警指挥学院拉萨分院	中国人民武装警察部队指挥学院拉萨分院
成教院	成教学院	成人教育学院
三台	三台县
石家庄陆指	石家庄陆军指挥学院	石陆指挥学院	中国人民解放军石家庄陆军指挥学院
音院	音乐学校	中国音乐学院	音教院	中央音乐学院	音乐教育学院	中音	音乐学院
武水	武汉水利电力大学
安庆电大	安庆广播电视大学
金程旅游培训	北京金程旅游培训学校
兰州商院	兰州商学院
南海	南海区
基奇纳	kitchener
风扇	电风扇	电扇
思科网院	思科网络技术学院
新民农用机场	沈阳新民农用机场
广西电力职院	广西电力职业技术学院	广西电力职业学院
远安	远安县
禹州	禹州市
沙特阿拉伯	sardiarabia	saudiarabia
巴基斯坦	pakistan	巴基斯坦伊斯兰共和国
苏格兰	scotland
上海出版印刷专科学校	上海出版印刷高等专科学校
10区	十区
月湖	月湖区
桥东	桥东区
丹寨	丹寨县
天峻	天峻县
四川航天职院	四川航天职业学院	四川航天职业技术学院
山西建筑职院	山西建筑职业技术学院	山西建筑职业学院
集安	集安市
莫尔伯勒	marlborough
宜黄	宜黄县
英特尔	intel	英特尔公司
衡阳	衡阳县	衡阳市
石家庄人民医专	石家庄人民医学专科学校	石家庄人民医学高等专科学校
威海	威海市
上影学院	上海电影艺术学院
皮件厂	皮具厂
埃斯普瑞特	esprit
利兹	leeds
港外大	香港外文大学
湖北警院	湖北警官学院
泉城旅职	泉城旅游职院	山东泉城旅游职业学院
安仁	安仁县
介休	介休市
明尼苏达	minnesota
金城江	金城江区
投促处	投资促进处
泰州机场	春兰机场	泰州春兰直升机场	泰州春兰机场
梅哈利	mehari
越城	越城区
虎林	虎林市
学校门	学校校门
海沧	海沧区
cah	首都机场集团公司
安塞	安塞县
乐至	乐至县
盐都	盐都区
cad	autocad
延大西安创新学院	延安大学西安创新学院
海拉尔	海拉尔区
黑龙江政管干	黑龙江政管干学院	黑龙江省政法管理干部学院
拜耳	bayer
清河门	清河门区
湖州职院	湖州职业技术学院	湖州职业学院
dxg	德之杰
织金	织金县
长江文理学院	长江大学文理学院
麦多	meeto
镭射	laser
历下	历下区
磴口	磴口县
二炮学院	第二炮兵指挥学院
建行	中国建行	建设银行	中国建设银行	chinaconstructionbank	中国建设银行股份有限公司	ccb
北影动画学院	北京电影学院动画学院
莱戈恩	leghorn
沈航	沈阳航空航天大学	沈阳航空大学
丰镇	丰镇市
珠江学院	珠江管理专修学院
紫琅职院	紫琅职业技术学院	紫琅职业学院
豫剧	河南梆子
林肯	lincoln
佳的美	gadmei
沈河	沈河区
水利局	水利建筑工程局
穆棱	穆棱市
屏东教大	屏东教育大学
青铜峡	青铜峡市
包头	包头市
经管	经管院	经济管理学院	经管学院	经院	mba
基础医学院	北大医学部基础医学院	北医基础医学院	北京大学医学部基础医学院	医学部基础医学院	北大基础医学院
古城	古城区
8区	八区
奥兹莫比卡	oldsmobile
量贩	ktv	ktv量贩式	量贩式ktv
江西外语外贸学院	江西外语外贸职业学院	江西外语外贸职院
福满居	福满居家具
城步	城步苗族自治县	城步县	城步自治县
河南北大附中	北大附属中学河南分校	北大附中河南分校	北京大学附属中学河南分校	北京大学附中河南分校
天津工程师范	天津工程师院	天津工程师范学院
唐山科技职院	唐山科技职业技术学院	唐山科技职业学院
民盟	中国民主同盟
安徽商贸学院	安徽商贸职业技术学院	安徽商贸职业学院
世新	台湾世新大学
泾源	泾源县
西姆拉	simla
霞山	霞山区
翻院	上外高级翻译学院	上外高翻学院	高级翻译学院	北外高级翻译学院	高翻学院	上海外国语大学高级翻译学院	北京外国语大学高级翻译学院	北外高翻学院
涟水	涟水县
茶餐厅	茶餐坊
雅漾	avene
喀拉库里湖	卡拉库里湖
深圳市经理进修	深圳市经理进修学院
灵川	灵川县
西澳大利亚	westernaustralia
托福	toefl
机关事务中心	机关事务管理中心
连云港师专	连云港师范专科学校	连云港师范高等专科学校
西南学院	西南俄勒冈社区学院
百图	betu	柏图
马特峰	matterhorn
中餐馆	中餐餐馆
开江	开江县
力狮	legacy
粤菜馆	粤菜菜馆
四川文化传媒职院	四川文化传媒职业学院
登喜路	dunhill
延长	延长县
华联学院	私立华联学院
质监局	质量技术监督管理局	技术监督局	技术监督管理局	质量技术监督局
西财行知学院	西安财经学院行知学院
符拉迪沃斯托克	vladivostok
长治职院	长治职业学院	长治职业技术学院
石家庄邮电职院	石家庄邮电职业技术学院	石家庄邮电职业学院
百威	budweiser	peavey
吉财	吉林财经	吉财大学	吉林财大	吉林财经大学
技校	技工学校	技术学校	技术学院	技工学院
职校	职业技术学校	职业技术学院	职业技工学院	职业技工学校	职业技校	职业学校	职业学院
太原	太原市
西平	西平县
新罕布什尔	newhampshire
沈阳航空职院	沈阳航空职业学院	沈阳航空职业技术学院
东北军政大学	东北军事政治大学
榆社	榆社县
升达大学	郑州升达大学
靖安	靖安县
微生物	微生生物
卢氏	卢氏县
乌当	乌当区
会宁	会宁县
江西公安学校	江西公安专科学校
瑞士	switzerland	瑞士联邦
中浦院	中国浦东干部学院
麻塞达里欧山	mercedario
托罗斯山脉	taurus
护理学院	北京大学护理学院	北大护理学院
贵教院	贵州教育学院
怡和	jardinematheson
北京企管院	北京企业管理研修学院
睿杰社区学院	焦作睿杰社区学院
斯特灵郡	stirlingshire
岳阳电大	岳阳广播电视大学
洛锡安	lothian
矿山	矿业
玉门	玉门市
普兰店	普兰店市
圣赫勒拿	对赫勒拿
咸阳师院	咸阳师范	咸阳师范学院
沃特福德	waterford
魏都	魏都区
三明电大	三明广播电视大学
成衣铺	裁缝店
沧源	沧源县	沧源自治县	沧源佤族自治县
湘乡	湘乡市
贵溪	贵溪市
如皋	如皋市
希巴	sheba
弗莱森电讯	verizoncommunications
天津师范	天津师范大学	天津师大
宝姿	ports
飞捷电子研究所	沈阳飞捷电子研究所
地震局	中国地震局
思博达	武汉思博达教育培训中心
泰国	thailand	泰王国
华侨双语双语	灌南华侨双语双语学校
长沙电力职院	长沙电力职业技术学院	长沙电力职业学院
汉川	汉川市
重庆邮院	重庆邮电学院
班车站	班车车站
商务部	中华人民共和国商务部	中国商务部	国家商务部
水电八局	中国水电八局	中国水利水电第八工程局
南航技术学院	南方航空技术学院
澳门机场	澳门国际机场
药科大	中国药科大学	中国药科大	药科大学
云大	云南大学
六安职院	六安职业技术学院	六安职业学院
教贤学院	香港国际教贤学院
勐腊	勐腊县
辽宁财经院	辽宁朝阳财经院	辽宁市朝阳财经学院	朝阳财经院
大庆机场	大庆萨尔图机场	萨尔图机场
丽台	winfast	leadtek
云浮电大	云浮广播电视大学
涞源	涞源县
钟表	钟表店
青海畜牧兽医职院	青海畜牧兽医职业技术学院	青海畜牧兽医职业学院
福贡	福贡县
龙门	龙门县
桦南	桦南县
物科院	物理科学学院
肯塔基	kentucky
湖南一师	湖南第一师范学院	湖南第一师范
涪城	涪城区
西藏社院	西藏社会主义学院
伊旗	伊金霍洛	伊金霍洛旗
八方	8方	捌方
青海建筑职院	青海建筑职业技术学院	青海建筑职业学院
喜马拉雅山	喜玛拉雅山
湖北财职院	湖北财税职业学院
合肥滨湖职院	合肥滨湖职业技术学院	合肥滨湖职业学院
昭觉	昭觉县
普光	普广
石家庄医专	石家庄医学专科学校	石家庄医学高等专科学校
龙港	龙港区
龙岗	龙岗区
吴川	吴川市
北外继教院	北外继续教育学院	北京外国语大学继续教育学院
北京一师附小	北京第一师范学校附属小学
中山职院	中山职业技术学院	中山市职业技术学院	中山职业学院
柳北	柳北区
亚管	亚洲管理学院
参事室	国务院参事室
界首	界首市
冀州	冀州市
青州	青州市
老干部大学	吉林省老干部大学	上海市老干部大学
土产品	土产产品
湖南大碗菜	湖南农家大碗菜	老家乡湖南大碗菜	湖南人大碗菜	百姓老厨湖南农家大碗菜
洪江	洪江市
越西	越西县
衡东	衡东县
广州产权交易	广州产权交易所
外贸局	经济贸易局	对外贸易局	外经贸局	对外贸易经济合作局	经贸局
诸城	诸城市
泸州职院	泸州职业技术学院	泸州职业学院
舍伦山脉	kjolenmts
新河	新河县
舟山机场	普陀山机场	舟山普陀山机场
修水	修水县
余干	余干县
和林格尔	和林格尔县
重庆工业职院	重庆工业职业技术学院	重庆工业职业学院
清流	清流县
澄江	澄江县
军工业	军工工业
南孤儿院	南孤儿学院
贵大	贵州大学
古晋	kuching
鹿特丹	rotterdam
肃北	肃北县	肃北自治县	肃北蒙古族自治县
马德里	madrid
凯迪拉克	cadillac
艺工学院	艺术工程学院
大连理工出版社	大连理工大学出版社
塞内加尔	塞内加尔共和国	senegal
伽师	伽师县
公安海警专校	公安海警高等专科学校	公安海警专科学校
武邑	武邑县
候车室	候车厅
洛轴职工大学	洛阳轴承集团有限公司职工大学
利旁廷阿尔卑斯山	lepontinealps
派克	parker
紫金	紫金县
武山	武山县
四方台	四方台区
中财委	中央财政经济委员会
古交	古交市
湖南高速铁路职院	湖南高速铁路职业学院	湖南高速铁路职业技术学院
侨谊	无锡市侨谊幼儿园	侨谊幼儿园
山南	山南市	山南地区
崇左	崇左市
卫东	卫东区
2院	第2人民医院	2医院	第二人民医院	二医院	第2医院	第二医院	二院
歌尔科技学院	潍坊学院歌尔科技学院
横路乡中心小学	衢江区横路乡中心小学
双桥	双桥区
规委	规划委	规划委员会
尼玛	尼玛县
四会	四会市
枝江	枝江市
郑州电力职院	郑州电力职业学院	郑州电力职业技术学院
菲亚特	fiat
泰院	泰山学院
双清	双清区
北门	北大门	北门口
天津工业职院	天津工业职业技术学院	天津工业职业学院
核电站	核电电站
北密	北京高等秘书研修学院
同德	同德县
孝感	孝感市
华夏学院	北京华夏管理	北京华夏管理学院	北京华夏学院
内格罗河	negro
通烈康	通烈康专卖店
富顺	富顺县
积石山	积石山自治县	积石山县	积石山保安族东乡族撒拉族自治县
嘉善	嘉善县
云阳	云阳县
北京工业职院	北京工业职业学院	北京工业职业技术学院
安娜苏	annasui	anna
红会	红十字会
巴塘	巴塘县
5院	五医院	第5人民医院	第5医院	5医院	五院	第五人民医院	第五医院
干院	中国干部学院	延安干部学院
万事通	mastone
祁门	祁门县
健雄职院	健雄职业学院	健雄职业技术学院
市政工程局	市政工程管理局
江西电大	江西广播电视大学
秭归	秭归县
硕泰克	soltek
巴精	重庆巴精火锅	巴精火锅
j.lo	詹妮弗.洛佩兹
浙广柯城分校	浙江广播电视大学柯城分校
天津外语学院	天津外国语学院
广东岭南职院	广东岭南职业学院	广东岭南职业技术学院
广州生物医药与健康研究院	中国科学院广州生物医药与健康研究院
诊所	诊疗所
耘赫创业学院	耘赫高级创业技术学院
警学院	暇察部队学院
南漳	南漳县
社会科学出版社	中国社会科学出版社
巴利亚多利德	valladolid
中共中央	中央委员会	中国共产党中央委员会
中文学院	北外中文学院	北京外国语大学中国语言文学学院	北外中国语言文学学院	中国语言文学学院
薛城	薛城区
厦门华夏职院	厦门华夏职业学院
保德	保德县
奥里萨巴山	orizaba
南政	解放军南京政治学院	南京政院	中国人民解放军南京政治学院	政客掌治学院	南京政治学院	政治学院
广东社院	广州社会主义学院
河南省社科院	河南省社会科学院
盟委	盟盟委员会	盟盟委会	盟委会	盟委员会	盟盟委
外经委	对外贸易经济委员会	外经委会
南京啉大	南京啉业大学
哈里法克斯	halifax
安庆职院	安庆职业技术学院	安庆职业学院
华师大增城学院	华南师范大学增城学院
陕西能源职院	陕西能源职业技术学院	陕西能源职业学院
日本通运	nipponexpress
砚山	砚山县
中戏	中央戏剧学院
体育局	体育总局	国家体育局	国家体育总局
陕西工业职院	陕西工业职业技术学院	陕西工业职业学院
嵊泗	嵊泗县
南站	南客站	南客运站	客运站南站	客运南站
道孚	道孚县
双台子	双台子区
组干学院	组织干部学院
华科管理学院	华中科技大学管理学院
延大农学院	延边大学农学院
新农大	新疆农业大学	新疆农大
凯特利斯	catlyst
内蒙古电大	内蒙古广播电视大学
泉州泰山航海职院	泉州泰山航海职业学院
biad	北京市建筑设计研究院
塘沽	塘沽区
香巴岛	香芭岛	香吧岛
国土局	国土资源局
巢湖	巢湖市
天传所	天津电气传动设计研究所
扬大	扬州大学
宜宾职院	宜宾职业技术学院	宜宾职业学院
9院	第9医院	九院	第九人民医院	第九医院	第9人民医院	九医院	9医院
东南门	东南门口
光大	ceb	光大银行	中国光大	chinaeverbrightbank	中国光大银行股份有限公司	中国光大银行
阿坝师专	阿坝师范高等专科学校	阿坝师范专科学校
雳霹道	rapido
上海财经学院	上海财政经济学院
峨边	峨边彝族自治县	峨边县	峨边自治县
新乡	新乡市	新乡县
惠州经济学院	惠州经济职业技术学院
倩碧	clinique
赛普拉斯	cypress
天津海运职院	天津海运职业学院
二连浩特	二连浩特市
您	你
莫洛托夫	molotov
大学	高校	高等专科学校	专科学校	高专学校	高等学校
新疆师范	新疆师范大学	新疆师大
方山	方山县
云南新兴职院	云南新兴职业学院
通辽	通辽市
宁波服装职院	宁波服装职业学院	宁波服装职业技术学院
谷歌中国	google中国	中国google	google
阿塞拜疆	阿塞拜疆共和国
中航勘察设计	中航勘察设计研究院
3小	三小	第三小学	第3小学
福州外语外贸学院	福州外语外贸职业技术学院	福州外语外贸职业学院	福州外语外贸职院
天津滨海职院	天津滨海职业学院
威海技术监督研究所	威海市技术监督信息研究所
景点	旅游景区	风景名胜区	生态文化旅游区	风景保护区	风景区	旅游景点	原生态景区	生态渡假区	风景名胜	生态度假区	原生态旅游区	旅游区	生态旅游度假区	风景旅游区	原生态旅游度假区	景区	风景自然保护区	原生态旅游渡假区	旅游风景区	原生态旅游景区	旅游度假区	原生态文化旅游区	自然保护区	自然旅游区	原生态渡假区	生态旅游渡假区	生态景区	生态旅游度假景区	原生态旅游渡假景区	原生态旅游度假景区	旅游渡假区	生态旅游区	自然风景区	原生态度假区	生态旅游渡假景区	自然风景保护区
信息专修学院	西安信息科技专修学院
平明大学	平明职业大学	平明职大
上海立达职院	上海立达职业学院	上海立达职业技术学院
铜山	铜山县
利物浦	liverpool
信州	信州区
西木	西木大学
玻利维亚	玻利维亚共和国
陕西经济管理职院	陕西经济管理职业学院	陕西经济管理职业技术学院
嵩口苗木协会	清流县嵩口苗木花卉协会
马尔代夫	马尔代夫共和国
中国石化协会	中国石油和化学工业协会
多伦多	toronto
^塘	^塘^
荆门	荆门市
城厢	城厢区
厦大管院	厦大管理学院
红塔	红塔区
松原职院	松原职业技术学院	松原职业学院
宁海	宁海县
昆明艺职	昆明艺术职业学院	昆明艺术职院
美津浓	mizuno
苏州经贸职院	苏州经贸职业学院
兰州商院长青学院	兰州商学院长青学院
内蒙古丰州职院	内蒙古丰州职业学院
鸡东	鸡东县
石门	石门县
思源学院	西安思源学院
洞头	洞头县
江苏警院	江苏警官学院
北服继教	北京服装学院继续教育学院
蚌埠经济职院	蚌埠经济职业学院	蚌埠经济职业技术学院
阿尔卑斯	alps
西宁	西宁市
哈学院	哈尔滨学院
上医大	上海医大	上海医科大学	上海医科大
青岛港湾职院	青岛港湾职业技术学院	青岛港湾职业学院
卡西欧	casio
成都东软信息技术职院	成都东软信息技术职业学院
宁河	宁河县
两当	两当县
大同机场	大同东王庄机场	东王庄机场
福建生物工程职院	福建生物工程职业学院	福建生物工程职业技术学院
泉州机场	晋江机场	泉州晋江机场
首都机场	北京国际机场	北京首都国际机场	北京机场	首都国际机场
清水河	清水河县
江川	江川县
福伦达	voigtlander
澳柯玛	青岛澳柯玛科技电器有限公司	aucma
漳州师范	漳州师范学院	漳州师院
石油成教院	西安石油学院成人教育学院
蒙大拿	montana
安泰管理学院	交大安泰管理学院	上海交通大学安泰管理学院
察布查尔	察布查尔自治县	察布查尔县	察布查尔锡伯自治县
罗姆福	romford
最高检	检察院	最高人民检察院	人民检察院	高检院
梧州机场	梧州长洲岛机场	长洲岛机场
城建局	城市建设管理局	行政执法局
朗泉	latruen	latruen朗泉
河海大	河海大学
江西省科协	江西省科学技术协会
现代管理大	北京管理大学	北京现代管理大学	北京现代大学
江达	江达县
潼关	潼关县
萨尔温江	salween
理学院	理学学院
尚义	尚义县
大连工大艺术与信息工程学院	大连工业大学艺术与信息工程学院
北安普顿郡	northamptonshire
四川商职院	四川商务职业学院	四川商务学院	四川商学院
欧米茄	omega
江大	江汉大学	江苏大学	江南大学
昌图	昌图县
皋兰	皋兰县
大连东软学院	大连东软信息学院	东软信息学院
威海职院	威海职业技术学院	威海职业学院
柳职院	柳州职业技术学院	柳州职业学院
西南交大希望学院	西南交通大学希望学院
船院	中国人民解放军镇江船艇学院	船艇学院	解放军镇江船艇学院	镇江船院	镇江船艇学院
海安	海安县
长江职院	长江职业学院
良子足记	良子足浴	良子足疗
楠达德维山	nandadevi
石职院	石家庄职业技术学院	石家庄职业学院
青原	青原区
耶路撒冷	jerusalem
合肥联大	合肥联合大学
伊春	伊春区	伊春市
含山	含山县
北京信工学院	北京信息工程学院
乌得勒克	utrecht
海底捞	海底捞火锅
马塞	marseilles
北科院	北京电子学院	北京电子科技学院
金台	金台区
喜房子	喜房子婚礼服务机构
迭部	迭部县
奥里萨邦	orissa
金坛	金坛市
美容	美发	整容	美容美发
杜甫国际语言	巩义市杜甫国际语言培训学校
柳城	柳城县
鄂前旗	鄂托克前旗	鄂托克前
储存	贮存
金堂	金堂县
丁青	丁青县
龙井	龙井市
北京朝阳工读学校	北京市朝阳工读学校
绍林吉高原	thuringianplateau
鞍师	鞍山师范	鞍山师范学院
nxp	恩智浦
蓝田	蓝田县
延寿	延寿县
金华	金华市
太工院	太原工业学院	太原工学院
菱钻	daimondata
扬州环境资源职院	扬州环境资源职业学院	扬州环境资源职业技术学院
老庄结构院	老庄建筑结构设计培训学院
城管大学	中国城市化特种管理部队大学
西军电	西安军事电讯工程学院
河南质量工程职院	河南质量工程职业学院
上海济光职院	上海济光职业技术学院	上海济光职业学院
吉安	吉安市	吉安县
北联旅游学院	北京联合大学旅游学院	北京联大旅游学院
雅姿	artistry
北京联大广告学院	北京联合大学广告学院
天津体院	天津体育学院
萨克拉门托	sacramento
兴业	兴业县
经理学院	厦门经理学院
莆田四中	福建省莆田第四中学
腊戎	lashio
万州	万州区
民培	民盟西安培训学院
成都大学学前教育	成都大学学前教育学院
银监会	银行业监督管理委员会	中国银行业监督管理委员会
天津公安职院	天津公安职业学院	天津公安警官职业学院
科尔沁	科尔沁区
~口	~口区
管城	管城回族区	管城区
兴义	兴义市
阎良机场	西安阎良机场
福彩	中国福利彩票	福利彩票
山东旅职	山东旅游职院	山东旅游职业学院
建筑工程总公司职工大学	陕西省建筑工程总公司职工大学
华德学院	华德应用技术学院
达日	达日县
成大	成都大学	成功大学	台湾成功大学
北京经职院	北京经济技术职业学院
西大资环院	西南大学资源环境学院
力杰	cenda
佛科院医学院	佛山科技学院医学院
机场	国际机场	直升机场	民航机场	飞机场	通用机场
三和学院	陕西三和专修学院
河北科大理工学院	河北科技大学理工学院
国泰君安香港	香港国泰君安
仄易远大	仄易远族大学
安阳师院	安阳师范学院	安阳师范
北流	北流市
重大外语学院	重庆大学外国语学院	重大外国语学院
互联网信息	中国互联网信息中心
松阳	松阳县
清华出版社	清华大学出版社
完美动力	完美动力动画学院
双牌	双牌县
武指天津分院	武警指挥学院天津分院	中国人民武装警察部队指挥学院天津分院
北川	北川自治县	北川县	北川羌族自治县
爱丽	etude
耿马	耿马自治县	耿马县	耿马傣族佤族自治县
江西农大成教学院	江西农业大学成人教育学院
泰医	泰山医学院
北林	东林大	北林大	林业大学	北京林业大学	北林区	林大	北京林大	东北林业大学	东林	东北林大
奥运	奥运会	奥林匹克运动会
利特里姆	leitrim
爱可视	archos	archosann
兴宾	兴宾区
北京石化学院	北京石油化工学院
维也纳	vienna
爱乐	ailesports
永平	永平县
礼泉	礼泉县
雅安	雅安市
北大	pekinguniversity	北京大学	pku
深州	深州市
额尔古纳	额尔古纳市
工业园	工业园区	工业区
阿斯克斯	asics
济宁职院	济宁职业学院	济宁职业技术学院
荣昌	荣昌县
伊犁师范	伊犁师范学院	伊犁师院
丰台	丰台区
贵池	贵池区
禹城	禹城市
汕尾职院	汕尾职业技术学院	汕尾职业学院
罗城	罗城自治县	罗城县	罗城仫佬族自治县
恺撒沙拉	凯撒沙拉
丝绸工学院	苏州丝绸工学院
红古	红古区
浙江警院	浙江警察学院
安徽邮电职院	安徽邮电职业学院	安徽邮电职业技术学院
苏州高博软件技术职院	苏州高博软件技术职业学院
苏州卫生职院	苏州卫生职业技术学院	苏州卫生职业学院
千瓦	千伏安
永城	永城市
阜宁	阜宁县
图拉	tula
葆丽美	suisseprogramme
利川	利川市
定兴	定兴县
康马	康马县
弋阳	弋阳县
台院	台州学院
盐城纺织职院	盐城纺织职业技术学院	盐城纺织职业学院
杭州电科大信息工程学院	杭州电子科技大学信息工程学院
浙江东方职院	浙江东方职业技术学院	浙江东方职业学院
上海托普信息技术职院	上海托普信息技术职业学院
广州华南商贸职院	广州华南商贸职业学院
诺丁汉	nottingham
图丽	tokina
梅园	梅园村
大堂	大堂^
西安理工大高科学院	西安理工大学高科学院
保定科技职院	保定科技职业学院
气象局	气象台	中国气象局
杰微	jwele
龙陵	龙陵县
靖宇	靖宇县
蒙特卡罗	montecarto
图勒	thule
大田	大田县
三军大学	三军联合参谋大学
威海机场	威海大水泊国际机场	大水泊国际机场	大水泊机场	威海国际机场
铜罗中心小学	吴江市铜罗中心小学
自动门业	自动门门业
西安职院	西安职业技术学院	西安职业学院
安工院	安阳工学院
临川	临川区
河南中等职校联合人才网	河南省中等职业学校联合人才网
斯梅西克	smethwick
厦工院	厦门工学院
大众	volkswagen
浙大附中	浙江大学附属中学	浙江大学附中	浙大附属中学
雅蕾学院	雅蕾职业技术培训学院
政法干部管理学院	福建省政法干部管理学院	福建政法干部管理学院
平乡	平乡县
石河子电大	石河子广播电视大学
泰科电子	tyco
鲁山	鲁山县
大英	大英县
会东	会东县
丽人堂	恒安丽人堂
人大	人民代表大会	全国人代会	人代会	中华人民共和国全国人民代表大会	全国人大	全国人民代表大会	中国人大	中国人民大学	人民大学	全国人大会	中国人民代表大会
浙海院东海科学技术学院	浙江海洋学院东海科学技术学院
迪奥	dior
广东房地产协会	广东省房地产业协会
临大	临沂大学	临时大学	长沙临时大学
粤城	粤城网络教育学院
湛江	湛江市
泰顺县育才学校	温州市泰顺县育才学校
昭阳	昭阳区
卢瓦尔河	loire
杭工院	杭州应用工程技术学院
现代学院	河北现代职业培训学院
大宇	daewoo
雷诺	renault
西岗	西岗区
景宁	景宁畲族自治县	景宁县	景宁自治县
孟津	孟津县
夜大	夜大学
农技站	农技推广站
大余	大余县
中牟电大	中牟县广播电视大学
晋中	晋中市
晋州	晋州市
同济职教学院	同济职业教育学院	同济大学职业教育学院
武乡	武乡县
华东师大出版社	华东师范大学出版社
武汉	武汉市
恩平	恩平市
塔古斯河	taugs
浈江	浈江区
蔡甸	蔡甸区
三江	三江自治县	三江县	三江侗族自治县
河北农大现代科技学院	河北农业大学现代科技学院
理塘	理塘县
撒马利亚	samaria
辽宁体院	辽宁省体育运动技术学院
华信学院	郑州华信学院
奥尔良	orleans
御茶水女大	御茶水女子大学
八幡	yawata
安徽水利水电职院	安徽水利水电职业学院	安徽水利水电职业技术学院
吉林电子信息职院	吉林电子信息职业技术学院	吉林电子信息职业学院
鑫谷	sego
中央法警学院	中央司法警官学院
浦干院	浦东干部学院
陕西国贸学院	陕西国际商贸学院
cggc	中国葛洲坝集团公司
西乡塘	西乡塘区
重庆活鱼	重庆乌江鱼	重庆乌江活鱼
开阳	开阳县
珲春	珲春市
爱快罗密欧	alfaromeo
体大	北体大	北京体大	体育大学	北京体育大学	北体
阿闻酋	拉伯联合酋长国
向阳	向阳区
残联	残疾人联合会
武侯	武侯区
四川管理职院	四川管理职业学院
武戏	武剧
华师大美院	华南师范大学美术学院
天津渤海职院	天津渤海职业学院	天津渤海职业技术学院
伦夫鲁郡	renfrewshire
河北电大	河北广播电视大学
奥美嘉	aomg
计算机测评中心	中国信息安全产品测评认证中心计算机测评中心
里贾纳	regina
白莲机场	柳州白莲机场	柳州机场
宁工院	宁波工程学院	宁波工学院
光华管理学院	北京大学光华管理学院	北大光华学院	北大光华管理学院
金阊	金阊区
曼彻斯特	manchester
湖南师大医学院	湖南师范大学医学院
漠河	漠河县
阳曲	阳曲县
扎格罗斯山脉	zagros
萨瑟兰瀑布	sutherlandfalls
北京广院	北京广播学院
嘉院	嘉兴学院
葫芦岛	葫芦岛市
广西工程职院	广西工程职业学院
中小企业协会	中国中小企业协会
库尔勒	korla	库尔勒市
建华	建华区
秦腔	陕西梆子
南航	南昌航空航天大学	航空航天大学	南京航天大学	南京航空航天大学	buaa	北航大学	北航	北京航空大学	南昌航空大学	北京航空航天大学	南京航空大学	南航大学	北京航天大学
开封	开封市	开封县
安远	安远县
黄骅	黄骅市
安源	安源区
英非尼迪	英菲尼迪
杭州三联学院	杭州三联专修学院
青师大	青海师范大学	青海师大	青海师范
济宁机场	济宁曲阜机场	曲阜机场
爱迪麦斯	edimax
内农大	内蒙古农大	内蒙古农业大学
赛博	赛博数码广场
湖南农科院	湖南省农业科学院
香天下	香天下清油火锅
天财	天津财经大学	天津财经	天财大学	天津财大
重庆医专	重庆医药专科学校	重庆医药高等专科学校
湖南科贸职院	湖南科技经贸职业学院	湖南科技经贸职业技术学院
西安医专	西安医学专科学校	西安医学高等专科学校
cec	中国电子信息产业集团有限公司
佛冈	佛冈县
致铭	cthim
江西泰豪动漫职院	江西泰豪动漫职业学院
南和	南和县
安岳	安岳县
求实学院	青岛求实职业学院	青岛求实学院	青岛求实职院	青岛求实职业技术学院
南京市社科院	南京市社会科学院
安泽	安泽县
南湖	南湖区
灌南	灌南县
咸陶院	咸阳陶瓷研究设计院
新海淀计算机学校	北京新海淀计算机学校
台伯河	tiber
华澳商贸学院	山西华澳商贸职业学院	山西华澳商贸学院
民勤	民勤县
江财	江西财经	江西财大	江财大学	江西财经大学
物资局	国家物资储备局	物资储备管理局	储备物资管理局	国家物资局
女工委	女工委会	女工委员会
刘集机场	襄樊机场	襄樊刘集机场
上杭	上杭县
自流井	自流井区
双江	双江自治县	双江拉祜族佤族布朗族傣族自治县	双江县
通辽职院	通辽职业学院	通辽职业技术学院
耿丹学院	工大耿丹学院	北京工业大学耿丹学院
特纳利夫岛	tenerife
正门	正门口
北京联合学院	北京联合大学师范学院
涿鹿	涿鹿县
沙河	沙河市
乐山师院	乐山师范学院	乐山师范
深圳旅院	深圳旅游学院
赛乌苏机场	二连浩特机场	二连浩特国际机场	二连浩特赛乌苏机场	赛乌苏国际机场	二连浩特赛乌苏国际机场
建东职院	建东职业学院	建东职业技术学院
临床医学院	天津医科大学临床医学院
武汉共大	武汉共产主义劳动大学
攀枝花	攀枝花市
北京社会管理职院	北京社会管理职业学院
市中	市中区
维扬	维扬区
莫斯科	moscow
淮阴电大	淮阴市广播电视大学
代办费	代理费
大连艺术职院	大连艺术职业学院
雅诗兰黛	esteelauder
歌剧院	歌剧剧院
7	第七	第7	七	柒	Ⅶ	no7
文明委	文明委会	精神文明工作指导委员会
枫林外经贸职院	江西枫林涉外经贸职业学院	枫林外经贸学院	枫林涉外经贸职业学院
湖工	湖南工业大学	湖南工大	湖北工大	湖工大	湖北工业大学
海粟美术	上海海粟美术设计学院
9小	九小	第九小学	第9小学
都昌	都昌县
妮维雅	nivea
荆楚理工	荆楚理工学院
国防学院	国防科技职业学院	国防科技学院	国防科技职院
涧西	涧西区
吉蒂屋	吉蒂屋－helloekitty专卖
委内瑞拉	委内瑞拉共和国	venezuela
黑龙江商职院	黑龙江商学院	黑龙江商业学院	黑龙江商业职业学院
四川联大	四川联合大学
贡嘎	贡嘎县
中巴学院	中国-巴基斯坦学院
润迅通信	润迅通信国际
铁岭	铁岭市	铁岭县
沈建大城市建设学院	沈阳建筑大学城市建设学院
芜湖信息技术职院	芜湖信息技术职业学院
智慧学院	智慧研究学院
西厢师院	西厢师范学院	西厢师范
三家子机场	齐齐哈尔三家子机场	齐齐哈尔机场
马斯顿	马其顿共和国
郑州美院	郑州美术学院
环保委	环境保护委员会	环保委员会
若石学院	若石健康研究学院
斯古吉尔河	schuylkill
蒙彼利埃	montpelier
广西农科院	广西壮族自治区农业科学院
莱阳	莱阳市
齐师院	齐齐哈尔师范	齐齐哈尔师范学院	齐齐哈尔师院
镇海	镇海区
交大软件学院	北京交通大学软件学院
太湖创意职院	太湖创意职业技术学院	太湖创意职业学院
忆捷	eaget
黑龙江法警职院	黑龙江司法警官职院	黑龙江司法警官职业学院
华师武汉传媒学院	华中师范大学武汉传媒学院
动物医院	宠物医院
辽宁警专	辽宁警官高等专科学校	辽宁警官专科学校
雪佛龙	chevron
郑州职院	郑州职业学院	郑州职业技术学院
瓦杜兹	vaduz
沁水	沁水县
山东化工职院	山东化工职业学院
山职医学院	山西职工医学院
广州体院	广州体育学院
哈尔滨华夏计算机职院	哈尔滨华夏计算机职业学院	哈尔滨华夏计算机职业技术学院
长乐机场	长乐国际机场	福州国际机场	福州长乐国际机场	福州机场
山东轻工学院	山东轻工业学院
上海工外	上海工商外语学院	上海工商外国语学院
曲靖	曲靖市
城东	城东区
喃海东软信息技术职院	喃海东软信息技术职业学院
麻江	麻江县
德黑兰	tehran
东大学院	陕西东大专修学院
平邑	平邑县
石龙	石龙区
斯塔万格	stavanger
苏州工业园区职院	苏州工业园区职业学院	苏州工业园区职业技术学院
文联	文学艺术界联合会	文艺联合会
河源电大	河源广播电视大学
石林	石林彝族自治县	石林县	石林自治县
社保	社保管理中心	社保中心	社保基金管理中心	社会保险	社会保险基金管理中心
平阴	平阴县
增城电大	增城市广播电视大学
亳州	亳州市
外教院	外语教育学院
装大	装修大学
高唐	高唐县
黑龙江农业工程职院	黑龙江农业工程职业学院
屯溪	屯溪区
杭州电科大	杭州电子科技大学
遵医医学与科技学院	遵义医学院医学与科技学院
贵阳机场	龙洞堡机场	龙洞堡国际机场	贵阳龙国际机场	贵阳龙洞堡国际机场
湖北美院	湖北美术学院
彰武	彰武县
河北交通职院	河北交通职业技术学院	河北交通职业学院
红山	红山区
云南文化艺术职院	云南文化艺术职业学院
高台	高台县
6院	第6人民医院	6医院	六院	六医院	第六医院	第六人民医院	第6医院
smbc	sumitomomitsuibankingcorporation	三井住友银行
丽江师专	丽江师范高等专科学校	丽江师范专科学校
升达	升达经贸管理学院
鲁泰学院	鲁泰纺织服装学院
南大商学院	南京大学商学院
桂工院	桂林工学院
广东交通职院	广东交通职业学院	广东交通职业技术学院
马尔维纳斯群岛(福克兰群岛)
定西	定西市
徐州电大	徐州广播电视大学
东华	东华大学
洛阳	洛阳市
新洲	新洲区
梅州	梅州市
庆阳	庆阳市
冰岛	iceland	冰岛共和国
鄂州	鄂州市
屏山	屏山县
雷克雅末克	reykjavik
师培大学	师资培育大学
市政工程处	市政工程管理处
华星学院	重庆华星外国语专修学院
宝应	宝应县
郝莲娜鲁宾斯坦	helenarubinstein
台州	台州市
宁蒗	宁蒗自治县	宁蒗彝族自治县	宁蒗县
桃仙机场	沈阳桃仙国际机场	沈阳国际机场	沈阳机场	桃仙国际机场
天财珠江学院	天津财大珠江学院	天津财经大学珠江学院
圣迭戈	sandiego
鼎湖	鼎湖区
富士	fuji	fujifilm
新郑	新郑市
芝麻餐馆	芝麻食馆
自贡	自贡市
北京现代职院	北京现代职业技术学院	北京现代职业学院
辞书	上海辞书出版社
工程院	中国工程院
大悟	大悟县
江孜	江孜县
奥波尔图	oporto
四川财职院	四川财经学院	四川财经职业学院
公安司法管干学院	辽宁公安司法管干学院	辽宁公安司法管理干部学院
明斯克	minsk
西藏警官专科学校	西藏警官高等专科学校	西藏警官高等学校
马鞍山二中	马鞍山市第二中学
汪清	汪清县
上海成教院	上海成人教育进修学院
西北门	西北门口
北邮经管学院	北京邮电大学经济管理学院	北邮经济管理学院
东信	eastcom
港理	香港理工大学	香港理工大	香港理工	港理大
中医院科技学院	江西中医药科技学院	中医学院科技学院	江西中医学院科技学院	江西中医药学院科技学院	江西中医科技学院	中医药科技学院	中医药学院科技学院
上林	上林县
广州行政职院	广州行政职业学院
东兴	东兴市	东兴区
巽他群岛	sundaisles
万源	万源市
国防科工局	国家国防科工局	国家国防科技工业局
汤阴	汤阴县
亚美尼亚	亚美尼亚共和国
山海关	山海关区
长城学院	长城研修学院
贵州师大求是学院	贵州师范大学求是学院
赤坎	赤坎区
吉兰丹	kelantan
山西旅游职院	山西旅游职业学院
计生委	中华人民共和国国家人口和计划生育委员会	人口计生委	计划生育委员会	人口和计划生育委员会
万载	万载县
文昌	文昌市
茂南	茂南区
青山湖	青山湖区
中心电大	中心广播电视大学
解放军外语学院	解放军外国语学院	中国人民解放军外国语学院
重庆建筑研究院	重庆市建筑科学研究院
湖南环境生物职院	湖南环境生物职业技术学院	湖南环境生物职业学院
江西工程职院	江西工程职业学院
大姚	大姚县
安全生产委员会	国务院安全生产委员会
冕宁	冕宁县
武威	武威市
社保部	劳动保障部	社会保险局	中华人民共和国人力资源和社会保障部	人力资源社保局	中国人力资源和社会保障部	人力资源和社保局	劳动和社会保障局	国家人力资源和社会保障部	劳动和社会保障	劳动社会保障部	人力资源和社会保障局	人力资源社会保障部	人力资源保障部	人社局	人力资源保障局	人力资源社会保障局	人力资源和社会保障部	劳动保障局	劳动社会保障	劳动局	社会保障部	劳动和社会保障部	社保局
广州民航职院	广州民航职业技术学院	广州民航职业学院
金坛五中	金坛市第五中学
第一师院	第一师范学院	第一师范
信息产品质监站	北京市信息产品质量监督检验站
武指乌鲁木齐分院	武警指挥学院乌鲁木齐分院	中国人民武装警察部队指挥学院乌鲁木齐分院
巴格达	baghdad
四方	四方区
齐鲁国际	齐鲁国际培训学院
华航	华北航天工业学院
巩义	巩义市
漯河食品职院	漯河食品职业学院
上海工艺美术职院	上海工艺美术职业学院
基金委	自然科学基金委员会	自然科学基金会	自然科学基金委	国家自然科学基金委员会
琼海	琼海市
华盛顿	washington
Malvinas	马尔维纳斯群岛(福克兰群岛)
威兰	welland
武冈	武冈市
贵州航天职院	贵州航天职业技术学院	贵州航天职业学院
晋源	晋源区
淮南	淮南市
大唐电信	st大唐
2小	第二小学	二小	第2小学
湘桥	湘桥区
确山	确山县
马达加斯加	madagascar	马达加斯加共和国
后门	后门口
肇庆	肇庆市
瑟孚	sirf	瑟孚科技
青岛黄海职院	青岛黄海职业学院
兴城	兴城市
金沙萨	kinshasa
怀化职院	怀化职业技术学院	怀化职业学院
莱姆顿学院	江南大学莱姆顿学院	江大莱姆顿学院
沂南	沂南县
卡尔施泰特	karstadtquelle
南市	南市区
华擎	asrock
雅顿	arden
武汉软件工程职院	武汉软件工程职业学院
花山	花山区
比特彗星	bitcomet
模拟器件	analogdeviceadi
汕头电大	汕头广播电视大学
天津石油职院	天津石油职业技术学院	天津石油职业学院
中医院	中医医院
浏阳	浏阳市
陕西	陕西省
新疆职大	新疆职业大学
西安陆院	西安陆军学院
洛多皮山脉	rhodope
舞院	舞蹈学院
胶州	胶州市
监利	监利县
伊莱克斯	electrolux
5小	第5小学	五小	第五小学
诺丁汉郡	nottinghamshire
北大网院	北大网络教育学院	北京大学网络教育学院
深泽	深泽县
沛纳海	panerai
罗甸	罗甸县
八十后	八零后
贝尔南方	bellsouth
永年	永年县
鹿城	鹿城区
泰兴	泰兴市
南师	华中师范大学	湖南师院	师院	湖师	北京师范大学	师范高等专科学校	师范大学	华南师范	东师大	湖南师范大学	师范专科学校	师范高等专科学院	南师大	华南师大	陕师大	南京师范	南京师大	陕西师范大学	华师	师范专科学院	华东师范大学	南京师范大学	师范学院	北师大	华师大	华东师范	师范专科	东师	北京师大	东北师范大学	东北师范	华中师大	华东师大	华中师范	陕西师范	东北师大	北京师范	湖南师大	陕师	师大	湖南师范	北师	师专	陕西师大	师范	湖师大	湖南师范学院	师范学校	华南师范大学
贵德	贵德县
鄯善	鄯善县
齐齐哈尔	齐齐哈尔市
欧宝	欧龙	opel
汕大医学院	汕头大学医学院
四中大	第四中山大学
北财	北财院	北京财院	北京财经学院	北京财经
白塔机场	白塔国际机场	呼和浩特机场	呼和浩特国际机场	呼和浩特白塔国际机场
广指	广指学院	中国人民武装警察部队广州指挥学院	武警广州指挥学院
都安	都安自治县	都安瑶族自治县	都安县
琴泰半岛	kintyre
维季姆河	vitim
赛琪	saiqi
贵州财院商务学院	贵州财经学院商务学院
杰克琼斯	jackjones	jack&jones
宁德师范	宁德师院	宁德师范学院
天津电子信息职院	天津电子信息职业技术学院	天津电子信息职业学院
栾城	栾城县
沙迦	sharjah
巫溪	巫溪县
五莲	五莲县	五连
津巴布韦	津巴布韦共和国
西林大	西南林大	西南林业大学
中科纳洁	北京中科纳洁环保科学研究院
鄞州中学	宁波市鄞州中学
湖南城建职院	湖南城建职业学院	湖南城建职业技术学院
唐海	唐海县
玉溪师范	玉溪师范学院	玉溪师院
宣城	宣城市
保谷	hoya
莲娜丽姿	ninaricci
松桃	松桃自治县	松桃县	松桃苗族自治县
宜家上海	上海宜家家居	上海宜家
珍奥健康爱心家园	珍奥核酸健康爱心家园
故居	故宅
屋子	房间
唐河	唐河县
青岛市地税局	青岛市地方税务局
拥军优属拥政爱民工作领导小组	全国拥军优属拥政爱民工作领导小组
上海新侨职院	上海新侨职业学院	上海新侨职业技术学院
新晃	新晃侗族自治县	新晃县	新晃自治县
建委	建委会	建设委员会
广西警专	广西警官高等专科学校	广西警官专科学校
海上救助机场	高东海上救助机场	上海高东海上救助机场
武汉体院体育科技学院	武汉体育学院体育科技学院
尼亚萨兰	nyasaland
秀水学院	秀水经济信息专修学院
武汉工业职院	武汉工业职业学院	武汉工业职业技术学院
抚顺朝鲜族一中	抚顺市朝鲜族第一中学
赫章	赫章县
湖南大众传媒职院	湖南大众传媒职业学院	湖南大众传媒职业技术学院
天津东大	天津东方妇女老年大学
基韦斯特	keywest
行健文理学院	广大行健文理学院	广西大学行健文理学院
西太平洋大学	西西里太平洋大学
磐石	磐石市
雅芳	avon
北方职业学院	内蒙古北方职业技术学院	内蒙古北方职业学院
东方文理学院	东方文理研修学院
度假村	渡假村	旅游度假村	旅游渡假村
北京蔬菜研究中心	北京市农林科学院蔬菜研究中心
青海警官职院	青海警官职业学院
邛崃	邛崃市
华天涉外	厦门华天涉外学院
坎伯拉	kampala
默克・天蝎座	merkurscorpio
银杏酒店管理学院	成都信息工程学院银杏酒店管理学院
中南林科大涉外学院	中南林业科技大学涉外学院
标星	biaoxing
苏州高新实验小学	苏州高新区实验小学
前郭尔罗斯	前郭尔罗斯蒙古族自治县	前郭尔罗斯自治县	前郭尔罗斯县
秦皇岛一中	秦皇岛市第一中学
中物院	中国工程物理研究院
星子	星子县
卢顿	luton
辽宁林业职院	辽宁林业职业学院	辽宁林业职业技术学院
华豫学院	学华豫学院
南木林	南木林县
雁山	雁山区
奔迈	palm
延吉机场	朝阳川国际机场	朝阳川机场	延吉朝阳川国际机场	延吉国际机场
临沧	临沧市
清河	清河县	清河区
图工委	教育部高校图工委
平山	平山县	平山区
永城职院	永城职业学院
临淄	临淄区
重理	重庆理工	重庆理工大学	重庆理工大	重理大
略阳	略阳县
石渠	石渠县
吴江职院	吴江职业学院	吴江职业技术学院
哈萨克斯坦	哈萨克斯坦共和国	kazakhstan
贵州	贵州省
遂溪	遂溪县
江西渝州科技职院	江西渝州科技职业学院
峡大科技学院	三峡大学科技学院
安徽新闻出版职院	安徽新闻出版职业学院	安徽新闻出版职业技术学院
浙江医专	浙江医学高等专科学校	浙江医学专科学校
信宜	信宜市
西理	西理大	西安理工大学	西安理工大	西安理工
燎原南汇广告学校	上海燎原南汇广告学校
亚加达教育机构	亚加达外语专修	广州市亚加达外语专修学院
南通职大	南通职业大学
5区	五区
中国科技学院	中国科学技术学院
翠峦	翠峦区
古冶	古冶区
绿春	绿春县
河管干	河北管理干部学院	河北管干学院
自考办	自学考试办公室	自考办公室	自学考试办
河北建工学院	河北建筑工程学院	河北建筑工学院	河北建筑学院
山东力明科技职院	山东力明科技职业学院
瑞丽	瑞丽市
西门子	siemens
锐步	reebok
柏乡	柏乡县
陆良	陆良县
喀喇沁	喀喇沁旗
东乡	东乡县
新城	新城区
煌上煌	皇上皇	皇上凰
天大	天津大学	津大
空雷	空军雷达学院	解放军空军雷达学院	中国人民解放军空军雷达学院	空雷院
蒂珀雷里	tipperary
广工院	广西工学院
景洪	景洪市
临洮	临洮县
江岸	江岸区
利雅得	riyadh
江安	江安县
先声	先声药业
第比利斯	tiflis
南京钟山职院	南京钟山职业学院	南京钟山职业技术学院
敦化	敦化市
漳平	漳平市
蓝色光标	蓝色光标公共关系机构
新乡职院	新乡职业技术学院	新乡职业学院
交通技师学院	广州市交通技师学院	广州市交通高级技工学校	广州交通技师学院
泸水	泸水县
金寨	金寨县
中瑞学院	中瑞酒店治理学院
浙江机电职院	浙江机电职业技术学院	浙江机电职业学院
吉林华侨外语学院	吉林华侨外国语学院
站前	站前区
三和银行	sanwabank
澳大利	australia	澳大利亚
嘉荫	嘉荫县
民政部	国家民政部	中华人民共和国民政部	中国民政部
会计学院	上海国家会计学院
北京燃气学院	北京市燃气集团燃气学院
潍城	潍城区
遂川	遂川县
涅瓦河	neva
上海总工会	上海市总工会
山大商务学院	山西大学商务学院
平遥	平遥县
周宁	周宁县
宝安	宝安区
广东理工职院	广东理工职业学院
寿阳	寿阳县
河北体院	河北体育学院
开发区	经济技术开发区	高新技术开发区	经济高新技术产业开发区	经济开发区	高新技术产业开发区	高新技术工业园
郑州信院	郑州通信学院
鲁中文武	山东鲁中文武学校
罗安达	luanda
敦煌	敦煌市
北航电脑学院	北京航空航天大学电脑学院
希思黎	sisley
二郎田鸡	二朗田鸡
重科院	重庆科技学院
建德	建德市
湖南交通职院	湖南交通职业技术学院	湖南交通职业学院
gt	佳通轮胎股份有限公司
望德堂	望德堂^
曲麻莱	曲麻莱县
杨凌职院	杨凌职业技术学院
西语学院	西方语言文化学院
江津	江津区
东至	东至县
济源	济源市
鹿泉	鹿泉市
莫罗尼	moroni
浙江邮电职院	浙江邮电职业技术学院	浙江邮电职业学院
吉林农大发展学院	吉林农业大学发展学院
东洲	东洲区
地税所	地方税务所
东芝	toshiba
萨摩斯岛	samos
青秀	青秀区
航母	航空母舰
语委	语委会	语言文字工作委员会
海宁	海宁市
沈阳	沈阳市
河北女子职院	河北女子职业技术学院	河北女子职业学院
山东圣翰财贸职院	山东圣翰财贸职业学院
木耳	黑木耳
长沙环境保护职院	长沙环境保护职业技术学院	长沙环境保护职业学院
乌恰	乌恰县
海南	海南区	海南自治州	海南省	海南藏族自治州	海南州	海南市
总院	总医院
湛江现代科技职院	湛江现代科技职业学院
文山机场	普者黑机场	文山普者黑机场
医科学院	中国中医科学院	中国中医学院	中医科学院
索普斯	sopc
牙防所	牙病防治所
渑池	渑池县
营口电大	营口广播电视大学
优群	argosy
塔什干	tashkent
云南国土资源职院	云南国土资源职业学院
乌干达	乌干达共和国
北警院	北京警察学院
江西农业工程职院	江西农业工程职业学院
广州城建职院	广州城建职业学院
德城	德城区
合江	合江县
网易公司	netease
工职院	工业职业学院	工职学院
斯特普尔斯	staples
海南科技职院	海南科技职业学院
杭州科技职院	杭州科技职业学院	杭州科技职业技术学院
厦门软件职院	厦门软件职业学院	厦门软件职业技术学院
青职院	青岛职业技术学院	青岛职业学院
贵工大	贵州工业大学	贵州工大
保山机场	保山云端机场
赛百味	赛百味subway	subway
桐城驾驶学校	桐城市机动车驾驶员培训学校
开化	开化县
财院	财经学院
新疆兵团警官专科学校	新疆兵团警官高等学校	新疆兵团警官高等专科学校
中大新华学院	中山大学新华学院
滨医	滨州医学院
新泽西	newjersey
港专教院	香港专业教育学院
沧州师院	沧州师范	沧州师范学院
军医大	军医大学
爱妒	爱妒婚纱摄影
嘉定区房屋土地管理局	上海市嘉定区房屋土地管理局
曲阜	曲阜市
相山	相山区
缅甸	缅甸联邦
泸医	泸州医学院
湖北工大工程学院	湖北工业大学工程学院
滇剧院	滇剧剧院
北奥	beall
凌科分析	南京凌科分析仪器应用研究所
南9门	南九门
金特尔	kintell
安乡	安乡县
大兴银行	grandnationalbank
辽宁建筑职院	辽宁建筑职业学院	辽宁建筑职业技术学院
利奥波德维尔	leopoldville
候机楼	航站楼
潜江	潜江市
岫岩	岫岩县	岫岩满族自治县	岫岩自治县
贝蒂	betty
双龙	ssangyong
平定	平定县
基隆	keelung	基隆市
双流	双流县
进贤	进贤县
楚州	楚州区
陕西航空职院	陕西航空职业学院	陕西航空职业技术学院
杭州职院	杭州职业学院	杭州职业技术学院
山西财专	山西财税专科学校	山西财政税务专科学校
湄公河	mekong
cdi	[深圳]中国综合开发研究院	深圳中国综合开发研究院	中国综合开发研究院	中国脑库	综合开发研究院
丰润	丰润区
宣州	宣州区
南5门	南五门
健身	健身房	健身俱乐部	健身中心	健身馆
宁波大学成教学院	宁波大学成人教育学院
沙洋	沙洋县
萨拉托夫	saratov
中原	中原区
哈尔滨金融专科学校	哈尔滨金融高等专科学校
张家界	张家界市
中远	中国远洋运输(集团)总公司	cosco	中远集运
电子工业学院	桂林电子工业学院
上海电影艺术职院	上海电影艺术职业学院
法警学院	司法警官学院
安康机场	安康五里铺机场	五里铺机场
西奈半岛	sinai
大连市台商协会	大连市台湾同胞投资企业协会
宝力豪	宝力豪健身国际连锁
硅湖职院	硅湖职业技术学院	硅湖职业学院
沈阳商业大厦	中兴沈阳商业大厦
全向	qxcomm
渝中区教院	渝中区教师进修学院
沙雅	沙雅县
湖里	湖里区
华沙	warszawa
韦氏英语	韦氏英语学院
趋势	trendnet
尼科巴群岛	nicobarislands
浙江工贸职院	浙江工贸职业学院	浙江工贸职业技术学院
魅族	meizu
左权	左权县
博莱凯	brica	深圳市博莱凯科技有限公司
定向井承包商协会	中国定向井技术服务承包商协会
陕科大	陕西科技大学	陕西科大
小金	小金县
榆树联社	榆树农村信用合作联社
定陶	定陶县
南充电大	南充广播电视大学
上海立信会计学院高等职院	上海立信会计学院高等职业学院	上海立信会计学院高等职业技术学院
第二轻工业职大	上海第二轻工业职工大学	第二轻工业职工大学
知青共大	知识青年共产主义劳动大学	内蒙古知识青年共产主义劳动大学
甘肃民族师范	甘肃民族师院	甘肃民族师范学院
永丰	永丰县
拉克伦河	lachlan
丽江	丽江市
甜点	甜食	甜品
东光	东光县
莒南	莒南县
大荣	daiei
沈工大工程学院	沈阳工业大学工程学院
江科大	江苏科大	江苏科技大学
桂工院博文管理学院	桂林工学院博文管理学院
甘肃工业职院	甘肃工业职业技术学院	甘肃工业职业学院
尖草坪	尖草坪区
中国医药集团总公司	sinopharm
康平	康平县
友康	ucom
绵竹	绵竹市
昆仑山脉	kunlun
武平电大	武平县广播电视大学
新源	新源县
新院	新乡学院
西亚斯学院	西亚斯国际学院
南京机场	南京国际机场	禄口国际机场	禄口机场	南京禄口国际机场
新邵	新邵县
温哥华	vancouver
五庄学院	五庄观道法管理学院
九龙	九龙县	kowloon
雁塔	雁塔区
临安	临安市
白城职院	白城职业学院	白城职业技术学院
航天职大	西南航天职工大学
外欧商学院	外欧国际工商学院
田纳西	tennssee
四川文化产业职院	四川文化产业职业学院
辛集	辛集市
北邮网院	北邮网络教育学院	北京邮电大学网络教育学院
爱奥尼亚	ionia
派卡德	packard
郑州交通职院	郑州交通职业学院
陕交	陕交大	陕西交大	陕西交通大学
标致	peugeot
徐汇业大	徐汇区业余大学
枞阳	枞阳县
江北葡萄研究所	山东省平度市江北葡萄研究所
内丘	内丘县
道真英语专修	道真英语专修学院
歌莉娅	歌莉娅服饰
索尔威湾	solwayfrith
bbva	西班牙对外银行	bancobilbaovizcayaargentaria
中法工程师学院	北航中法工程师学院	北京航空航天大学中法工程师学院
台电	teclast
山东电大	山东广播电视大学
麦旗	microdisk
钟山	钟山县	钟山区
顺驰	顺驰房产	顺驰地产	顺驰不动产
吉林公安专科学校	吉林公安高等专科学校
珠山	珠山区
平顺	平顺县
棒约翰	棒!约翰	papajohn“spizza
华尔学院	青岛华尔文理学院
金莎学院	广州金莎国际美容美发学院
石家庄计算机职院	石家庄计算机职业学院
潮汕机场	揭阳机场	揭阳潮汕机场
吉利大学	北京吉利大学
郑州角色人学校	河南省郑州市角色人电脑培训学校
天津航空大学	天津航空航天大学
日报社	日报报社
武鸣	武鸣县
那格浦尔	nagpur
精防中心	精神卫生防治中心
歌美	gemei
宜家北京	北京宜家家居	北京宜家
黄陂	黄陂区
家私	家h	家具
思茅师专	思茅师范专科学校	思茅师范高等专科学校
武警	中国人民武装警察部队	武装警察部队	武装警察	中国武装警察部队
特克斯科斯群岛	特克斯和凯科斯群岛
央企	中央企业
盘锦职院	盘锦职业技术学院	盘锦职业学院
香港机场	香港国际机场	香港赤v角国际机场
中共	中国共产党
香河	香河县
武科大	武汉科大	武汉科技大学
帝柔	diesel
衡南	衡南县
北通	betop
实验高级	日照实验高级中学
山东社院	山东社会主义学院
北2门	北二门
湖南艺职	湖南艺术职业学院	湖南艺术职院
山西	山西省
诺基亚	nokia	诺机亚	诺基亚(nokia)公司
嘉祥	嘉祥县
勃利巨人电脑技校	勃利县巨人电脑培训技校
博茨瓦纳	博茨瓦纳共和国
克罗地亚	克罗地亚共和国
武汉科大城市学院	武汉科技大学城市学院
恒生银行	恒生银行有限公司	中国恒生	中国恒生银行	恒生银行(中国)有限公司
昂昂溪	昂昂溪区
驾协	驾驶员协会
伊犁州电大	伊犁州广播电视大学
湖北省盐务局	湖北省盐务管理局	湖北省盐管局
施格兰	西格拉姆	seagram
士伦	toulon
倍嘉	aper
仁寿	仁寿县
重工院	重庆工学院
南涧	南涧自治县	南涧县	南涧彝族自治县
城隍庙小吃	城隍庙特色小吃
遂昌	遂昌县
南京	南京市
谷埠路小学	柳州市谷埠路小学
蒲剧院	蒲剧剧院
新疆天山职院	新疆天山职业学院	新疆天山职业技术学院
哈商大	哈尔滨商大	哈尔滨商业大学
满城	满城县
南靖	南靖县
天津社院	天津社会主义学院
东北2门	东北二门
尚志	尚志市
上海农林职院	上海农林职业学院	上海农林职业技术学院
牙买加	jamaica
南7门	南七门
上大法学院	上海大学法学院
北市教大	台北市立教育大学
宁夏工商学院	宁夏工商职业学院	宁夏工商职院	宁夏工商职业技术学院
江西	江西省
广大纺院	广州大学纺织服装学院
石铁大	石家庄铁大	石家庄铁道大学
射洪	射洪县
曼斯菲尔德	mansfield
fiyta	深圳市飞亚达(集团)股份有限公司
南京陆指	中国人民解放军南京陆军指挥学院	南京陆军指挥学院	南陆指挥学院
奥迪	audi
当阳	当阳市
全国总社	中华全国供销合作总社	全国供销合作总社	中国全国供销合作总社
长江工程职院	长江工程职业学院	长江工程职业技术学院
昆西	quincy
银川科技职院	银川科技职业学院
肥城	肥城市
汇美舍	prettyrally
西安科技商贸职院	西安科技商贸职业学院
安新	安新县
肃州	肃州区
乾安	乾安县
鹰潭职院	鹰潭职业学院	鹰潭职业技术学院
bea	thebankofeastasia	东亚银行	东亚银行(中国)有限公司	东亚银行有限公司	东亚中国	中国东亚银行
海航	海军航空工程学院	中国人民解放军海军航空工程学院	海航工程学院
博达	bdcom	博达通信
嘉兴	嘉兴市
怀宁	怀宁县
汉中	汉中市
英飞凌	infineon
奥德赛	odyssey
重点电大	重点广播电视大学
微软之星	microstar
外文学院	北师大外文学院	外国语言文化学院	北京师范大学外文学院
佐世保	sasebo
南4门	南四门
塞舌尔	塞舌尔共和国	seychelles
温州科技职院	温州科技职业学院
工艺美院	厦门工艺美术学院
六盘水	六盘水市
绥芬河	绥芬河市
华南理工公开学院	华南理工大学公开学院
广河	广河县
成理	成都理工	成都理工大学	成理大	成都理工大
北达科他	northdakota
延安抗大	延安抗日军政大学
山师	山西师范	山西师范大学	山东师范大学	山东师范	山师大	山西师大	山东师大
马提兹	matiz
中技大	中东技术大学
中山	中山市	中山区
自来水管	自来水水管
哈苏	hasselblad
烟台工程职院	烟台工程职业学院	烟台工程职业技术学院
广汉	广汉市
广西演艺职院	广西演艺职业学院
花旗集团	citigroup
拉纳克郡	lanarkshire
迪亚多纳	diadora
盘锦	盘锦市
孟菲斯	memphis
中国	china	中华人民共和国
铜职院	铜陵职业技术学院	铜陵职业学院
于洪	于洪区
西南科大城市学院	西南科技大学城市学院
百草源	百草园
荆州市电大	荆州市广播电视大学
吉财信息经济学院	吉林财经大学信息经济学院
同洲模范学校	上海市同洲模范学校
薇姿	vichy
汨罗	汨罗市
美索不达米亚	mesopotamia
呷哺	呷哺呷哺
土库曼	土库曼斯坦	turkmenistan
v亭	v亭区
达州职院	达州职业技术学院	达州职业学院
安徽绿海商务职院	安徽绿海商务职业学院
广东邮电职院	广东邮电职业学院	广东邮电职业技术学院
百诺	benro
乌拉特前	乌拉特前旗
医学院	医学学院
郑州铁路职院	郑州铁路职业技术学院	郑州铁路职业学院
齐齐哈尔职院	齐齐哈尔职业学院
国税所	国家税务所
郴州	郴州市
大石桥	大石桥市
广州工程技术职院	广州工程技术职业学院
施强学院	施强国际培训学院
牛排	牛扒
吉林	吉林省	吉林市
阜阳职院	阜阳职业技术学院	阜阳职业学院
淄博	淄博市
本田	hondamotor	honda
李沧	李沧区
食物学院	食物科学取养分工程学院
长春信息技术职院	长春信息技术职业学院
榆林	榆林市
羽毛球场	羽毛球馆
朝阳师专	朝阳师范专科学校	朝阳师范高等专科学校
浙科院	浙江科技学院
益阳职院	益阳职业技术学院	益阳职业学院
提贝斯提高原	tibesti
勤茂	twinmos
黎城	黎城县
甘肃建筑职院	甘肃建筑职业技术学院	甘肃建筑职业学院
东乡族	东乡族自治县	东乡族县
泉州纺织服装职院	泉州纺织服装职业学院
云南	云南省
wepec	大连西太平洋石油化工有限公司
莎车	莎车县
新北	新北区
新市	新市区
协和医大	中国协和医科大学	协和医科大
武汉体科院	武汉体育科技学院
临漳	临漳县
福建商专	福建商业专科学校	福建商业高等专科学校
嘉荫一中	黑龙江省嘉荫县第一中学
威严警沈阳指挥学院	中国群众威严警警察军队沈阳指挥学院
蓬莱	蓬莱市
友谊大学	人民友谊大学
余姚	余姚市
壶关	壶关县
河曲	河曲县
锦州商职院	锦州商学院	锦州商务职业学院	锦州商务学院
斯内克河	snake
广西生态工程职院	广西生态工程职业学院	广西生态工程职业技术学院
杭州幼师	杭州幼师学院	杭州幼儿师范	杭州幼儿师范学院
金女大	金陵女子大学
长白山职院	长白山职业学院	长白山职业技术学院
新宾	新宾自治县	新宾县	新宾满族自治县
鄂温克族	鄂温克族自治旗
微山	微山县
乐驰	spark	斯巴达克
哈利佰顿	halliburton
威达	vivitar
威格敦郡	wigtownshire
秀丽服装	广州市秀丽服装学院
浙江社院	浙江省社会主义学院
天峨	天峨县
汤团	汤圆
白银有色金属职工大学	白银有色金属公司职工大学
实捷	sage
阳明	阳明区
艺术学院	东大大连艺术学院	大连艺术学院	广西艺术学院	东北大学大连艺术学院
溪湖	溪湖区
四飞院	第四飞行学院
福建电力职院	福建电力职业学院	福建电力职业技术学院
巴宝莉	burberrys
琼台师专	琼台师范专科学校	琼台师范高等专科学校
新沂	新沂市
培正学院	广东培正学院
圣戈班	saint-gobain	saintgobain
运动学院	四川省运动技术学院
北京科盛培训	北京科盛培训中心
山大管院	山东大学管理学院	山大管理学院
永登	永登县
鸡西	鸡西市
永德	永德县
大连东软信息技术职院	大连东软信息技术职业学院
九头鸟	九头鸟酒家
龙安	龙安区
华龙学院	华龙数字艺术学院
疾病预防	中国疾病预防控制中心
黑科院	黑龙江科技学院
河北美院	河北美术学院
赛普特	sceptre
植保院	植物保护学院
阿克苏	阿克苏地区	阿克苏市
陕西旅游烹饪职院	陕西旅游烹饪职业学院
蝶妆	dknydebon	lgdebonlg
中央电视塔	中央广播电视塔
多哈	doha
威特岛	isleofwight
otc	非处方药
北京理工出版社	北京理工大学出版社
合水	合水县
阜康	阜康市
盐田	盐田区
农业部	中华人民共和国农业部	中国农业部	国家农业部
烟台职院	烟台职业学院
龙岩电大	龙岩广播电视大学
新医	新乡医学院
平武	平武县
新野	新野县
城院	河北工业大学城市学院	城市学院	浙江大学城市学院	浙大城市学院	北京城市学院	大连理工城市学院	大连理工大学城市学院
华佳磐英	hdtpy
西顿	sidon
黄陵	黄陵县
科左中旗	科尔沁左翼中旗	科尔沁左翼中
拉丁姆	latium
芷江	芷江自治县	芷江侗族自治县	芷江县
黄龙	黄龙县
江永	江永县
新大科学学院	新疆大学科学学院
摩拉瓦河	morava
常德	常德市
岳阳楼	岳阳楼区
港南	港南区
东北5门	东北五门
江油	江油市
岭南职院	岭南职业学院	岭南职业技术学院
蒙茅斯郡	monmcutshire
包头轻工职院	包头轻工职业学院	包头轻工职业技术学院
萍乡	萍乡市
青岛恒星职院	青岛恒星职业学院	青岛恒星职业技术学院
彩印	彩艺印刷
crcc	中国铁建股份有限公司
湖南科技职院	湖南科技职业学院
城市科技学院	重庆大学城市科技学院	重大城市科技学院
南昌市社院	南昌市社会主义学院
总支	总支委员会	总支委	总支委会
韩通韩国语	上海韩通韩国语学院
乌审	乌审旗
车管站	车管所	机动车辆管理所	车辆管理站	车辆管理所
密西西比	mississippi
资流学院	资流研修学院
万信	worthy
白银电大	白银广播电视大学
温职院	温州职业技术学院	温州职业学院
东院	上海外国语大学东方语学院	上外东院	上外东方语学院	东方语学院
江苏电力设计院	江苏省电力设计院
莫纳亨	monaghan
格尔木	格尔木市
马尾	马尾区
东源	东源县
外澳学院	外澳旅逛取酒店办理学院
广商院华商学院	广东商学院华商学院
亚热带农业生态研究所	中国科学院亚热带农业生态研究所
云南师大商学院	云南师范大学商学院
万秀	万秀区
海南蔬菜研究所	海南省农业科学院蔬菜研究所
海伦	海伦市
铁山港	铁山港区
蓝晨	bmorn
西班牙	spain
机电学院	机械电子工程学院	上海机电学院
省农函大	福建省农村致富技术函授大学
广西幼儿师专	广西幼师专科学校	广西幼儿师范高等专科学校
威宁	威宁自治县	威宁县	威宁彝族回族苗族自治县
海盗船	corsair
浩沙健身	浩沙健身俱乐部
七星	七星区
中青旅总社	中国青年旅行社总社
保加利亚	保加利亚共和国
头屯河	头屯河区
惠州	惠州市
雨湖	雨湖区
四平职大	四平职业大学
同江	同江市
宁大科院	宁波大学科技学院	宁大科技学院	宁波大学科学学院
松滋	松滋市
弥勒	弥勒县
赤水	赤水市
精保院	精神卫生保健院
潼南	潼南县
昌都	昌都县	昌都地区	昌都市
望都	望都县
广南	广南县
迈拓	maxtor
见奇	北京见奇电子机械研究所	见奇研究所
辽科大	辽宁科技大学	辽宁科大
支行	分理处
广宁	广宁县
北京社院	北京社会主义学院
大兴安岭	大兴安岭地区	大兴安岭市
嵩山少林武职	嵩山少林武术职业学院
北塔	北塔区
赣榆	赣榆县
辉瑞	pfizer
湘大	湘潭大学
南财红山学院	南京财经大学红山学院
王益	王益区
汕头农科所	汕头市农业科学研究所
桐柏	桐柏县
潮阳实验学校	广东省汕头市潮阳实验学校
戴尔	戴尔公司	dell
民革	中国国民党革命委员会
湄洲小吃	眉州小吃
鲅鱼圈	鲅鱼圈区
东西湖	东西湖区
房管所	房产管理所	房地产管理所
冈仁波齐	kangrinpoche
保监会	保险监督委员会	保监委员会	保险监督管理委员会	中国保险监督管理委员会	circ	中保监	中国保监会
极地	onepolar
广东警院	广东警官学院
外交部	国家外交部	中华人民共和国外交部	中国外交部
福建经管干	福建经济管理干部学院
三灶机场	珠海三灶国际机场	珠海国际机场	三灶国际机场	珠海机场
南锡	nancy
丽萨	leeza
楚雄	楚雄自治州	楚雄彝族自治州	楚雄市	楚雄州
成安	成安县
桃山	桃山区
华索	vaso
连山	连山区	连山自治县	连山壮族瑶族自治县	连山县
僧大	僧伽大学
cces	中城快递
恩施机场	恩施许家坪机场	许家坪机场
拉萨	lhasa	拉萨市
密克罗尼西亚	密克罗尼西亚联邦	micronesia
贝吉獾	badger
华水	华东水利学院
张家口	张家口市
斯希丹	schiedam
北京八维	北京八维学院	八维研修学院	北京八维研修学院
闽北职院	闽北职业学院	闽北职业技术学院
防汛抗旱总指挥部	国家防汛抗旱总指挥部
突泉	突泉县
华硕	asus
蒙自	蒙自县
梅德斯通	makdstone
罗马尼亚	romania
厦体大	厦门体育大学
山西煤炭职工联大	山西煤炭职工联合大学
钢铁公司职工大学	钢铁有限责任公司职工大学	南昌钢铁有限责任公司职工大学
西安商行	西安市商业银行	xacb	xi'ancitycommercialbank
沙巴	sabah
天津铁道职院	天津铁道职业技术学院	天津铁道职业学院
卢齐诺	lucino
冠捷易美逊	envisiontcl
辽阳	辽阳县	辽阳市
上海工会管理职院	上海工会管理职业学院
大连希望专修学校	大连希望教育专修学校
四平一中	四平市第一高级中学
池州职院	池州职业学院	池州职业技术学院
巴拿马	巴拿马共和国
省委	省省委会	省委员会	省委会	省省委员会	省省委
South	南乔治亚岛和南桑德韦奇岛
雪兰莪	selangor
淮安机场	淮安涟水机场	涟水机场
湖南理工职院	湖南理工职业技术学院	湖南理工职业学院
北原大	台北原住民部落大学
亚澳商学院	辽大亚澳商学院	辽宁大学亚澳商学院
hr	赫莲娜
hp	惠普中国	hewlettpackard	中国惠普	惠普
秦都	秦都区
福工院	福建工程学院	福建工学院
伊斯兰堡	islamabad
江西服装职院	江西服装职业技术学院	江西服装职业学院
蛟河	蛟河市
徽菜	安徽菜
中央社院	中央社会主义学院
双峰	双峰县
达能	danone
武汉商院	武汉商业服务学院
启东机场	南通启东直升机场
煤监局	安监管理局	安全监管局	安监局	煤矿安全监察局	煤矿安监局	安全监督管理局	安全生产监督管理局	国家煤矿安全监察局
广州铁路职院	广州铁路职业技术学院	广州铁路职业学院
贾汪	贾汪区
上大高技学院	上海大学高等技学学院	上大高等学院
林甸	林甸县
苍溪	苍溪县
dmx	迪美视
龙维	ecom
河南师大新联学院	河南师范大学新联学院
获嘉	获嘉县
马德拉群岛	maderia
北京经贸职院	北京经贸职业学院
凌源	凌源市
嘉和1品	嘉禾一品	嘉和一品	嘉禾1品	嘉和一品粥	嘉禾一品粥
宏状元	宏状元粥
中胡医科院	中胡医学科学院
东莞联合管理学院	东莞市联合管理专修学院
新右旗	新巴尔虎右旗	新巴尔虎右
雪肌丽	swissline
临武	临武县
香武仕	sunwoods
米其林	michelin
留坝	留坝县
川音演艺学院	四川音乐学院国际演艺学院
渡假	度假
九州机场	珠海九州直升机场
上海发改委	上海市发展和改革委员会	上海市发改委
昌江	昌江县	昌江自治县	昌江区	昌江黎族自治县
上海黄交所	上海黄金交易所
大红鹰学院	宁波大红鹰学院
石家庄科技工程职院	石家庄科技工程职业学院
铜陵	铜陵县	铜陵市
隆回	隆回县
曼谷	bangkok
熊猫	panda
华师大南海学院	华南师范大学南海学院
地瓜房	地瓜坊
票务	飞机票火车票售票点	售票点	火车票代售点	火车票代售处	票务处	飞机票火车票售票处	汽车票代售点	车票代售点	汽车票代售处	车票代售处	票务中心	飞机票火车票	火车票飞机票售票点	火车票飞机票售票处	客票代售点	火车票飞机票	客票代售处	售票处
巴黎世家	balenciaga
湘潭职院	湘潭职业技术学院	湘潭职业学院
dataland	北京市迪兰恒进科技有限公司	powercolor
莱阳农院	莱阳农学院
墨尔本	melbourne
鲁美	鲁迅美院	鲁迅美术学院	鲁美学院
昆明工业职院	昆明工业职业学院	昆明工业职业技术学院
浪卡子	浪卡子县
地拉那	tirana
信阳涉外职院	信阳涉外职业学院	信阳涉外职业技术学院
吉商院	吉林商学院	吉林工商学院
遗址	遗址公园
巴拉圭	巴拉圭共和国
铜梁	铜梁县
baosteel	宝钢集团有限公司
迪尔	deere
武陵	武陵区
尼罗河	nile
临渭	临渭区
川农大网院	四川农业大学网络教育学院
邵阳医专科	邵阳医学专科学校	邵阳医学高等学校	邵阳医学高等专科学校
吉大珠海学院	吉林大学珠海学院
北京农管干	北京农业管理干部学院	北京市农业管理干部学院
安徽工大工商学院	安徽工业大学工商学院
基里巴斯	kiribati	基里巴斯共和国
莱芜职院	莱芜职业学院	莱芜职业技术学院
寒亭	寒亭区
高科	getek
商丘医专	商丘医学高等专科学校	商丘医学专科学校
塔斯曼海	tasmansea
新开	singkep
中格拉摩根	midglamorgan
汉学院	汉学学院
安徽国际商务	安徽国际商务职业学院	安徽国际商务学院
中美合资	中美合资浦江县天地幼儿园
瑶海	瑶海区
宏伟	宏伟区
冬芭手烧	东芭手烧
马提尼克岛	martinique
中国矿院	中国矿业学院
结防所	结核防治所	结核病防治所
转业干部安置工作小组	国务院军队转业干部安置工作小组
长沙商旅职院	长沙商贸旅游学院	长沙商旅学院	长沙商贸旅游职业技术学院	长沙商贸旅游职业学院
昆剧院	昆剧剧院
交行	bcm	中国交行	交通银行	中国交通银行	bankofcommunications	交通银行股份有限公司
黑水	黑水县
离石	离石区
北京财职院	北京财贸职业学院	北京财贸学院
执政府	执政政府
阿根廷	阿根廷共和国
存款	储蓄
利比亚	大阿拉伯利比亚人民社会主义民众国	libya
投促局	投资促进局
联大商务学院	北京联合大学商务学院
南昌机场	南昌国际机场	昌北国际机场	昌北机场	南昌昌北国际机场
篱笆墙外	overthehedge
中央美院	中央美术学院
信达外国语	杭州市余杭信达外国语学校
连云港陇海教育	连云港陇海教育培训学院
山西警官专科学校	山西警官高等专科学校
铜鼓	铜鼓县
新科	shinco
宜春职院	宜春职业学院	宜春职业技术学院
ups	联合包裹运输服务
移动博士	unisbox
西安东方亚太职院	西安东方亚太职业技术学院	西安东方亚太职业学院
海港	海港区
渝州科技职院	渝州科技职业学院
北京技师学院	北京市工业技师学院	北京工业技师学院
琅琊	琅琊区
马鲁蒂	maruti
煤研院	煤炭科学研究院	煤科院	煤炭研究院
南岸	南岸区
色宾河	sabine
南安	南安市
潍坊	潍坊市
蒸湘	蒸湘区
闽剧	福州戏
石景山社区学院	北京市石景山区业余大学
贵港职院	贵港职业学院
泸溪	泸溪县
华美学院	西安华美学院
中方	中方县
息大	息烽大学
建始	建始县
陕西理工	陕西理工学院
晋城	晋城市
中非	中非共和国
台北体院	台北市立体育学院
宣城职院	宣城职业技术学院	宣城职业学院
屏北社大	屏东县屏北区社区大学
国展	国展中心	会议展览中心	国际展览	国际会议展览	国际会展中心	国际会展	会展中心	会议展览	会展	国际会议展览中心	国际展览中心
河南商专	河南商业专科学校	河南商业高等专科学校
景东	景东自治县	景东县	景东彝族自治县
西安建科大学华清学院	西安建筑科技大学华清学院
四川工程职院	四川工程职业技术学院	四川工程职业学院
云南交通职院	云南交通职业学院	云南交通职业技术学院
江西经管院	江西经济管理职业学院	江西经济管理学院
驾本	驾驶证	驾照	驾驶照	驾证
娥佩兰	opera
中大管院	中山大学管理学院
南澳	南澳县
南柏	南柏实业
江西航空职院	江西航空职业技术学院	江西航空职业学院
西北2门	西北二门
铜仁职院	铜仁职业技术学院	铜仁职业学院
黑龙江工商职院	黑龙江工商职业技术学院	黑龙江工商职业学院
浙财东方学院	浙江财经学院东方学院
乌苏	乌苏市
圣文森特和格林纳丁斯
商南	商南县
火电站	火电电站
潍医	潍坊医学院
南阳机场	姜营机场	南阳姜营机场
劳氏	lowes	lowe's
上海应用学院	上海应用技术学院
戴姆勒克莱斯勒	daimlerchrysler
哈尔滨德强商务学院	哈尔滨商业大学德强商务学院
广西国际商务职院	广西国际商务职业学院	广西国际商务职业技术学院
鹤山	鹤山区	鹤山市
南通航运职院	南通航运职业技术学院	南通航运职业学院
资料学院	资料科学工程学院
欧文斯坦利山脉	owenstanleyrange
惠城	惠城区
讷河	讷河市
上海桐柏中学	上海市桐柏高级中学
陕西职院	陕西职业技术学院	陕西职业学院
江阳	江阳区
横峰	横峰县
长清	长清区
湖北国土资源职院	湖北国土资源职业学院
林荫大道	parkavenue
罗克斯巴勒郡	roxburghshire
尚格学院	尚格益动数字艺术在线教育学院
尼亚萨湖	nyasa
宜宾机场	菜坝机场	宜宾菜坝机场
山工艺	山东工艺美术学院	山工艺美术学院	山东工美学院	山东工艺美院
国务院残疾人工委	国务院残疾人工作委员会
甸	myanmar	缅甸
公主岭	公主岭市
斯温登	swidon
青田	青田县
东胜	东胜区
怀安	怀安县
山阳	山阳区	山阳县
苏丹	sudan	苏丹共和国
延津	延津县
日土	日土县
上海水务规划院	上海市水务规划设计研究院
北1门	北一门
南京师大附属实验学校	南京师范大学附属实验学校
法尔曼	valmont
旅之星	travelstar
长沙翻译学院	长沙新时代外国语翻译专修学院
石嘴山	石嘴山市
东莞理工城市学院	东莞理工学院城市学院
等比利斯	tbilisi
世界外国语中学	上海市世界外国语中学
法制办	国务院法制办	国务院法制办公室
杨浦中学	上海杨浦高级中学
接待厅	会客厅
农学会	农学学会
百色职院	百色职业学院
潜院	潜艇学院
贵州交通职院	贵州交通职业技术学院	贵州交通职业学院
禅院	佛学学院	佛学院
凤冈	凤冈县
长清电大	长清广播电视大学
三宝垅	semarang
凰庭	溪上凰庭
富士通集团	fujitsu
滨州	滨州市
林州	林州市
塔吉克斯坦	tajikistan	塔吉克斯坦共和国	tadzhikistan
杂货铺	杂货店
拍得丽	premier
翠屏	翠屏区
地税局	地方税务局
ovc	奥凯华科
菜市场	菜市市场
东南8门	东南八门
邵阳电大	邵阳广播电视大学
卡撒天娇	卡撒天娇家纺
昂立学院	昂立游戏学院
沃尔库塔	vorkuta
齐河	齐河县
德州科技职院	德州科技职业学院
温县一中	温县第一高级中学
辽宁金融职院	辽宁金融职业学院	辽宁金融学院
内黄	内黄县
文化部	中华人民共和国文化部	中国文化部	国家文化部
河南电大	河南广播电视大学
女师院	女子师范学院	女师学院	女子师范	女子师院
斯巴达	sparta
微捌	微8	微八
村	村庄
广播工商学院	浙江广播电视大学工商学院
杭州林大	杭州林业大学
福安	福安市
绿城育华	杭州绿城育华学校
南乐	南乐县
羊宝涮肉坊	羊宝涮肉房
化德	化德县
巴音郭楞	巴音郭楞自治州	巴音郭楞蒙古自治州	巴音郭楞市	巴音郭楞州
实验幼儿园	南京实验幼儿园
武指昆明分院	武警指挥学院昆明分院	中国人民武装警察部队指挥学院昆明分院
丰南	丰南区
昙华林小学	武汉市武昌区昙华林小学
石家庄铁路职院	石家庄铁路职业技术学院	石家庄铁路职业学院
社科院	中国社科院	中国社会科学院	社会科学院
区委	区委员会	区委会	区区委	区区委会	区区委员会
丰宁	丰宁自治县	丰宁县	丰宁满族自治县
中央电大西藏学院	中央广播电视大学西藏学院
兴国	兴国县
塞拉利昂	sierraleone	塞拉利昂共和国
勐海	勐海县
现代	hyundai
向风群岛	windwardislands
现大	现代管理大学
中兴	zte
民和	民和自治县	民和县	民和回族土族自治县
干洗店	洗衣店
u拓	u2o
中铁石家庄职院	中铁石家庄职业技术学院	中铁石家庄职业学院
定日	定日县
罗孚	rover
湖南	湖南省
康柏	康柏电脑	compaq
静乐	静乐县
吉吉斯坦	kyrgystan
清华美院	清华大学美术学院	清华美术学院
河北能源职院	河北能源职业技术学院	河北能源职业学院
台湾社大	台湾社区大学
西创学院	宁夏西部创业技能培训学院
华亭	华亭县
葡萄牙	葡萄牙共和国
召陵	召陵区
花地堂	花地堂^
书画国大	中国书画国际大学
万宝路	marlboro
西溪学院	西溪成人教育学院
台儿庄	台儿庄区
宁强	宁强县
绵阳	绵阳市
奥得河	oder
新星	nova
潮汕学院	潮汕职业技术学院
工经所	工业经济研究所
海南电大	海南广播电视大学
石城	石城县
陕教院	陕西教育学院
梅萨	metz
浙江宇翔外院	浙江宇翔外国语专修学院
南宁	南宁市
集美	集美区
三亚学院	海南大学三亚学院	海大三亚学院
奈曼	奈曼旗
洛兹	luaz
盐边	盐边县
南6门	南六门
}方各堂	}方各堂^
电通	dentsu
信息大学	中国信息大学
合山	合山市
美商威特	wintec
内蒙古交通职院	内蒙古交通职业技术学院	内蒙古交通职业学院
托克托	托克托县
天镇	天镇县
番禺	番禺区
尤蒂卡	utica
包河	包河区
职业工学院	沙洲职业工学院
映泰	biostar
润州	润州区
西大	鸡西大学
山东经院燕山学院	山东经济学院燕山学院
大宁	大宁县
澳大利亚	澳大利亚联邦
铁锋	铁锋区
太原城市职院	太原城市职业学院	太原城市职业技术学院
南方高科	soutec
云南林业职院	云南林业职业技术学院	云南林业职业学院
金凤呈祥	金凤成祥
互通	立交	立交桥
中心社院	中心社会主义学院
东阿	东阿县
承德电大	承德广播电视大学
元朗	元朗^
移动之星	ydstar
沃希托河	ouachita
旧地	故地
卢昂	rouen
寻甸	寻甸回族彝族自治县	寻甸县	寻甸自治县
洮南	洮南市
黑龙江生态工程职院	黑龙江生态工程职业学院
tpco	天津钢管集团股份有限公司
平桥	平桥区
商都	商都县
艾迪康	itcom
蓬莱深奥生物科技	山东蓬莱深奥生物科技研究所
乐山大佛文武学校	四川乐山大佛文武学校
振安	振安区
中科院沈阳生态所	中国科学院沈阳应用生态研究所
清水	清水县
武强	武强县
湖南工商管理学院	湖南工商管理专修学院
民干院	民乾院	民族乾部学院	民干学院	民族干部学院	民乾学院
马斯喀特	muscat
谷城	谷城县
米德尔塞克斯	middlesex
贝塔斯曼	bertelsmann
兖州电大	山东广播电视大学兖州学院
重庆电大	重庆广播电视大学
临潭	临潭县
银川	银川市
喃宁职院	喃宁职业技术学院	喃宁职业学院
古塔	古塔区
镜湖	镜湖区
小店	小店区
凌志	lexus	雷克萨斯
山财	山西财大	山财大学	山西财经大学	山西财经	山东省财政学院
邯郸职院	邯郸职业学院	邯郸职业技术学院
钱江	钱塘江
武财	武财大学	武汉财大	武汉财经大学	武汉财经
青浦中学	上海市青浦高级中学
辽阳职院	辽阳职业技术学院	辽阳职业学院
五接桥小学	南通市五接桥小学
卡里巴水库	kariba
联大	联合大学
蓝宝	sapphire
环球雅思学校	环球雅思培训学校
信息产业部	中国信息产业部	中华人民共和信息产业部	国家信息产业部
深大成教学院	深圳大学成教学院	深圳大学成人教育学院
薛城区双语实验小学	枣庄市薛城区双语实验小学
艾利和	iriver
乐陵	乐陵市
西北新世纪	西北新世纪培训学院
华中大学	武昌华中大学
瓦努阿图	瓦努阿图共和国
德一	得一
武昌	武昌区
江西师大附中	江西师范大学附属中学
克里提娜	克丽缇娜
博通	broadcom
滨城	滨城区
抚宁	抚宁县
崇外	崇文门外
双敏	unika
唐山工业职院	唐山工业职业技术学院	唐山工业职业学院
邵武	邵武市
永宁	永宁县
萨拉多河	salado
井研	井研县
泰达学院	南大泰达学院	南开大学泰达学院
伊宁	伊宁市	伊宁县
浦江	浦江县
博乐	博乐市
房屋拆迁办	房屋拆迁管理办公室	房屋拆迁办公室
国家测绘局	国家测绘地理信息局
方正软件学院	方正软件技术学院
长沙南方职院	长沙南方职业学院
德银	中国德意志银行	deutschebank	德意志银行股份公司	德意志银行	德意志银行(中国)有限公司
巢湖职院	巢湖职业技术学院	巢湖职业学院
公开大学	香港公开大学
投行	投资银行
中国食品质量报	中国食品质量报社
东星航空学院	东星航空旅游专修学院
南部	南部县
曼图亚	mantua
博爱	博爱县
重庆医大	重庆医科大学	重庆医科大
劳伦斯	lawrence
长江勘测设计院	长江勘测规划设计研究院
塔吉特	target
盐湖	盐湖区
长江理工学院	长江理工专修学院
机电大学	甘肃机械电子职工大学	机械电子职工大学	机械电子大学
怀来	怀来县
真锅	真锅咖啡
阳江职院	阳江职业学院	阳江职业技术学院
所罗门群岛	solomonislands	年罗门群岛
厦新	amoisonic
技能桥	山东技能桥职业学校
青农大	青岛农业大学	青岛农大
eibc	theexport-importbankofchina	进出口银行	中国进出口银行
日本	japan	日本国
保康	保康县
行贿	贿赂
杭州电大	杭州广播电视大学
麦拿仑	mclaren
广工华立学院	广东工业大学华立学院
贺州	贺州市
大海大	大连海洋大学
南昌	南昌市	南昌县
上饶职院	上饶职业技术学院	上饶职业学院
昆山电大	昆山电视大学
郑大升达学院	郑州大学升达经贸管理学院
安徽工业经济职院	安徽工业经济职业学院	安徽工业经济职业技术学院
福州电大	福州广播电视大学
南岔	南岔区
山东农科院	山东省农业科学院
梁河	梁河县
长丰	长丰县
苍南实验一小	苍南县第一实验小学
茅箭	茅箭区
烟台师范	烟台师院	烟台师范学院
南财	南京财经大学	南京财大	南财大学	南京财经
博白	博白县
云南警院	云南警官学院
诚信佳	诚信佳购物
河科大	河北科技大学	河南科技大学	河北科大	河南科大
兵器产业园培训学院	西安兵器产业园培训学院
塔那那利佛	tananarive
青船院	青岛远洋船员学院
武大珞珈学院	武汉大学珞珈学院
工布江达	工布江达县
土右旗	土默特右	土默特右旗
西安软件学院	西安软件工程技术学院
东湖	东湖区
北卡罗来纳	northcarolina
强生	johnson
西武百货	西武百货seibu	seibu
名山	名山县
泰	泰钜	lanready
中国农科院	中国农业科学院
六合	六合区
化州	化州市
湘雅医学院	中南大学湘雅医学院	中南大湘雅医学院
示范性职院	示范性职业技术学院	示范性职业学院
石家庄女院	石家庄女子职业学院
军地学院	北京军地学院	北京军地专修学院
株洲职院	株洲职业技术学院	株洲职业学院
农大成教院	云南农业大学成教学院
南华城建学院	南华大学城市建设学院
山东凯文科技职院	山东凯文科技职业学院
阳泉	阳泉市
常工院	常州工学院
包头机场	二里半机场	baotouairport	包头二里半机场
桂林激光通信	桂林激光通信研究所
仙居	仙居县
广州番禺学院	广州番禺职业技术学院	广州番禺职业学院
无锡甘露幼儿园	无锡市甘露中心幼儿园
公安	公安县
丽水	丽水市
麦盖提	麦盖提县
斯柯达	skoda
龙洞	龙崆洞
une	融合网络
润泽堂	润泽汤
圣马力诺	sanmarino	圣马力诺共和国
南3门	南三门
汇丰银行	hongkongandshanghaibankingcorporation	中国汇丰	hsbc	香港上海汇丰银行有限公司
广西东方外语职院	广西东方外语职业学院
勒克脑	lucknow
广州南洋理工职院	广州南洋理工职业学院
南海东软信息技术职院	南海东软信息技术职业学院
高苑	台湾高苑技术学院
中德学院	邢台中德技师培训学院
郑轻院	郑州轻工学院	郑州轻工业学院
南科电子电器研究所	南京南科电子电器研究所
上冈高中	江苏省上冈高级中学
乌兰察布医专	乌兰察布医学专科学校	乌兰察布医学高等专科学校
北科天津学院	北京科技大学天津学院
国软院	国际软件学院	国软学院
生资院	生物资源学院
包头电大	包头广播电视大学
莱山	莱山区
mcc	中国冶金科工集团有限公司
富宁	富宁县
南昌航院	江西南昌航空学院	南昌航空工业学院
物流学院	北师大珠海分校物流学院	北京师范大学珠海分校物流学院
梅诺卡岛	minorca
德江	德江县
山东外贸学院	山东外贸职业学院	山东外贸职院
信丰	信丰县
上海人学院	上海成人继续教育学院
黑龙江三江美术职院	黑龙江三江美术职业学院
清华附中	清华附属中学	清华大学附属中学	清华大学附中
安科院	安徽科技学院
英豪网络营销学院	上海英豪教育进修学院-网络营销学院
因斯布鲁克	innsbruck
中南民大工商学院	中南民族大学工商学院
法国幽兰	orlane
上海旅专	上海旅游专科学校	上海旅游高等专科学校
华特曼	waterman
望京慈善协会	朝阳区望京慈善协会
洪都拉斯	洪都拉斯共和国
西市	西市区
中心美院	中心美术学院
江西太阳能科技职院	江西太阳能科技职业学院
徐州师大科文学院	徐州师范大学科文学院
太仆寺	太仆寺旗
东北科大	东北科技大学
太科大	太原科技大学	太原科大
山西面馆	山西面食馆
柯城	柯城区
法库	法库县
金士顿	kingston
申通	申通e物流	申通快递
索尼	sonyericsson	索尼爱立信	索爱	索尼爱立信公司	爱立信	sony	ericsson
东联大	东方联合大学
贝佳斯	borghese
外南财大	外南财经政法大学
坦喀尼喀	tanganyika
摩苏尔	mosul
上海体院	上海体育学院
汪齐风芭蕾舞学校	上海汪齐风芭蕾舞专修学校
铁道警专	铁道警官高等专科学校	铁道警官专科学校
郁美净	yumeijing
学尔森	学尔森专修学院
防空兵指挥学院	中国人民解放军防空兵指挥学院	解放军防空兵指挥学院
房地产研究所	清华大学房地产研究所	清华房地产研究所
阿克苏诺贝尔	akzonobel
阿乐卡特	alcatel	阿尔卡特
广州中院	广州市中级人民法院
重庆科创职院	重庆科创职业学院
云南师大文理学院	云南师范大学文理学院
艾妮诗	广州艾妮诗
新疆	新疆省	新疆维吾尔自治区
新建	新建县
大庆师院	大庆师范	大庆师范学院
努库阿洛法	nukualofa
漳教院	漳州教育学院
豫香苑	豫香园
冠盟	gamen
东大远教院	东大远程教育学院	东南大学远程教育学院
林学院	林学学院	浙江林学院
宝塔	宝塔区
爱欧迪	iaudio
宾阳	宾阳县
承德	承德市	承德县
当雄	当雄县
渝州家厨	渔舟家厨
交通部	中华人民共和国交通运输部	中国交通运输部	交通运输部	国家交通运输部	中华人民共和国交通部
拉萨机场	拉萨贡嘎国际机场	贡嘎国际机场	拉萨国际机场	贡嘎机场
墨累河	murry
韩国菜	韩国料理
左贡	左贡县
苏拉特	surat
龙川	龙川县
西安航专	西安航空技术专科学校	西安航空技术高等专科学校
锦江学院	川大锦江学院	四川大学锦江学院
中医学院	河南中医学院	安徽中医学院	江西中医学院	中国民间中医学院	湖北中医学院	河南中医药学院	陕西中医药学院	湖北中医药学院	中医药学院	云南中医药学院	甘肃中医药学院	安徽中医药学院	云南中医学院	辽宁中医学院	江西中医药学院	贵阳中医药学院	中国民间中医药学院	辽宁中医药学院	陕西中医学院	甘肃中医学院	贵阳中医学院	民医学院
井冈山	井冈山市
天津体院运动与文化艺术学院	天津体育学院运动与文化艺术学院
清新	清新县
尼加拉瀑布	niagarafalls
福交院	福建交通学院	福州交通技术学院
包头师院	包头师范学院	包头师范
临颍	临颍县
西昌	西昌市
登封	登封市
黑大剑桥学院	黑龙江大学剑桥学院
梅山学院	梅山实验学院
日本菜	日本料理
西南门	西南门口
迈克尔杰克逊	michaeljackson
武指合肥分院	中国人民武装警察部队指挥学院合肥分院	武警指挥学院合肥分院
清徐	清徐县
牧野	牧野区
浙江横店影视职院	浙江横店影视职业学院
二炮	中国第二炮兵部队	解放军第二炮兵	中国人民解放军第二炮兵部队	解放军第二炮兵部队	中国人民解放军第二炮兵	中国第二炮兵	人民解放军第二炮兵	第二炮兵	人民解放军第二炮兵部队	第二炮兵部队
河大工商学院	河北大学工商学院	河北工商学院
桑日	桑日县
契尔氏	kiehl's	kiehls
西藏	西藏省	西藏自治区
赤峰	赤峰市
大埔	大埔县	大埔^
上海师大美术学院	上海师范大学美术学院
东城	东城区
淳化	淳化县
锡剧院	锡剧剧院
台北市部大	台北市原住民部落社区大学
防城	防城区
柳江	柳江县
封开	封开县
克东	克东县
波斯尼亚和黑塞哥维那	波斯尼亚和黑塞哥维那共和国
陶瓷学院	陶瓷(珠宝)艺术设计学院
扶余	扶余县
杜尚e	dushanbe
济医	济宁医学院
百花文艺	百花文艺出版社
湖南电大	湖南广播电视大学
安阳职院	安阳职业技术学院	安阳职业学院
四川国际标榜职院	四川国际标榜职业学院
圣多美和普林西比
重庆电大企管学院	重庆广播电视大学企业管理学院
咏仕	咏仕服饰
川外成都学院	四川外语学院成都学院
香港	香港特别行政区
海西	海西自治州	海西市	海西州	海西蒙古族藏族自治州
利隆圭	liongwe
影院	国际影院	国际电影院	电影影院	国际影城	电影城	国际电影城	电影广场	电影厅	电影院	影城	影厅	影剧院
大理	大理白族自治州	大理市	大理州	大理自治州
滦平	滦平县
江苏财经职院	江苏财经职业学院
重庆五里店职业中学	重庆市五里店职业中学
碧欧泉	biotherm
绵阳职院	绵阳职业学院	绵阳职业技术学院
托坎廷斯河	tocantins
海南软件职院	海南软件职业学院	海南软件职业技术学院
周二	星期二	礼拜二
行署	行政公署
栖霞	栖霞区	栖霞市
常山	常山县
杏林科技职院	杏林科技职业学院
龙马潭	龙马潭区
杭州万向职院	杭州万向职业技术学院	杭州万向职业学院
高等学院	高技学院
关岭	关岭自治县	关岭县	关岭布依族苗族自治县
甘农大	甘肃农业大学	甘肃农大
威特沃特斯兰德	witwatersrand
乐清	乐清市
张家界航空工业职院	张家界航空工业职业技术学院	张家界航空工业职业学院
医科院	中国医学院	医学科学院	中国医学科学院	中国医科院
吉林化肥农药协会	吉林省化肥农药工业协会
江淮学院	安大江淮学院	淮阴工学院江淮学院	安徽大学江淮学院
山西运城农业职院	山西运城农业职业学院	山西运城农业职业技术学院
辉南	辉南县
阳泉师专	阳泉师范专科学校	阳泉师范高等专科学校
照象馆	照相馆	照像馆
德信	eutech
环卫局	环境卫生管理局
崇明	崇明县
德兴	德兴市
江西法警职院	江西法警职业学院	江西司法警官职业学院
西北联大	西北联合大学
鲁文佐里山脉	ruwenzori
扬州扦脚	杨州扦脚
开福	开福区
工行	工商银行	中国工商银行股份有限公司	industrialandcommercialbankofchina	中国工商银行	中国工行	icbc
肥乡	肥乡县
铁路工程职工大学	西安铁路工程职工大学
7院	第7人民医院	七院	七医院	7医院	第七医院	第七人民医院	第7医院
广州康大职院	广州康大职业技术学院	广州康大职业学院
昆山登云科技职院	昆山登云科技职业学院
欧宝车	欧宝汽车
婺城	婺城区
城建院	城市建设学院	城建学院	河南城建学院	河南城建院
摩凡陀	movado
武安	武安市
宁波银行	宁波银行股份有限公司	bankofningbo	nbcb
南京特教院	南京特殊教育职业技术学院	南京特殊教育职业学院
视觉学院	复旦大学上海视觉艺术学院	上海视觉艺术学院	复旦上海视觉艺术学院
萨基姆	sagem
里士满	richmond
凯伊秀	凯依秀
临沧师专	临沧师范高等专科学校	临沧师范专科学校
保健所	保健站	保健院
汕大	汕头大学
宣汉	宣汉县
研诺科技	analogictechaati
通化师范	通化师范学院	通化师院
邕大	邕江大学
武穴市农业局	湖北省武穴市农业局
北湖	北湖区
桂医	桂林医学院
武汉理工华夏学院	武汉理工大学华夏学院
中大医学院	中山大学医学院	中山大学中山医学院	中大中山医学院	香港中文大学医学院
上海巨人网络科技有限公司	giantinteractivegroupinc
西夫韦	safeway
长春师范	长春师院	长春师范学院
鹰潭电大	鹰潭广播电视大学
梅达莲	medallion
尼泊尔	尼泊尔王国	尼泊	nepal
诺仕	nicey
锅里壮	锅里壮食府
四川卫管干	四川卫生管理干部学院	四川省卫生管理干部学院
台海大	台湾海洋大学
北海	北海市
兴化	兴化市
米奇	mickey
疏附	疏附县
景德镇陶院	景德镇陶瓷学院
安徽外语职院	安徽外国语职业学院	安徽外国语职业技术学院
双城	双城市
徐闻	徐闻县
沙大	沙巴大学
milk	密耳克河
江西电教馆	江西省电化教育馆
佳木斯	佳木斯市
0	零	
沙煲粥	沙锅粥	砂锅粥	砂煲粥
山东杏林科技职院	山东杏林科技职业学院
颍州	颍州区
智慧星双语	大同智慧星双语幼儿园
江苏信息职院	江苏信息职业技术学院	江苏信息职业学院
邑大	五邑大学
广安	广安市	广安区
定陵机场	北京定陵机场
新不伦瑞克	newbrunswick
枣庄科技职院	枣庄科技职业学院
上海地方志	上海市地方志办公室
诺福克	norfolk
沈大	沈阳大学
农工党	中国农工民主党
华北革大	华北人民革命大学
南洋理工	广州南洋理工学院
带岭	带岭区
桂教院	桂林市教育学院	桂林教育学院
柏帛丽	burberry
林波波河	limpopo
广州华职	广州华商职业学院	广州华商学院
郑州经干院	郑州经济管理干部学院
广东女子职院	广东女子职业学院	广东女子职业技术学院
安阳实验小学	瑞安市安阳实验小学
吉化学院	吉林化工学院
多普达	多普达通讯有限公司	dopod
王焱钢琴	王焱钢琴学校
泰职院	泰州职业学院	泰州职业技术学院
蒙罗维亚	monrovia
无锡	无锡市
楚雄师附小	楚雄师范学院附属小学校
淮安师范	淮安师范学院	淮安师院
尼加拉河	niagara
马来西亚	malaysia
豪利时	oris
桥香园	江氏兄弟桥香园
电信院	电子信息工程学院	电信学院
天青院	天津青年职业学院	天津青年职院
临江	临江市
郑大旅管学院	郑州大学旅游管理学院
科丽妍	lacolline
法拉利	ferrari	ferarri
网通	中国网通
徐其修	徐其修凉茶
莱佛士学院	莱佛士国际设计学院	东华大学莱佛士国际设计学院	东华莱佛士国际设计学院
凤城高级中学	莱芜市莱城区凤城高级中学
广西政管干	广西政法管理干部学院	广西政管干学院
蔡司	carlzeiss
迈创	matrox
咖啡店	咖啡馆	咖啡厅
东升科技学院	东升科技专修学院
西政	西南政法大学	西南政法
静海	静海县
黄河水土监督局	黄河水土保持西峰治理监督局
敦煌机场	甘肃敦煌机场
河池	河池市
中女院	中华女子学院
岳麓	岳麓区
南京铁道职院	南京铁道职业学院	南京铁道职业技术学院
无为	无为县
平凉	平凉市
全椒	全椒县
普利劳斯	plymouth
梵帝	fendi
西2门	西二门
科威特	kuwait	科威特国
金河田	goldenfield
秦皇岛机场	秦皇岛山海关机场	山海关机场
陆丰	陆丰市
bob	bankofbeijing	北京银行	北京银行股份有限公司	北京市商业银行
西站	客运站西站	客运西站	西客站	西客运站
社旗	社旗县
9区	九区
凤梨释迦	释迦凤梨
阿曼	oman	阿曼苏丹国
岭东	岭东区
爱特梅尔	atmel
迪厅	舞厅
柯尼卡	konica
川大	四川大学
桑丽卡	soniarykiel
玉林师范	玉林师范学院	玉林师院
迁西	迁西县
新会	新会区
桂冠	laurel
云南医专	云南医学高等专科学校	云南医学专科学校
拉多加湖	ladoga
兵团电大	兵团广播电视大学
阳山	阳山县
大交	大交大	大连交大	大连交通大学
碑林	碑林区
尚维果	尚维果蛋糕坊
荷兰银行	abn-amrobank
拉特兰	rutland
温医仁济学院	温州医学院仁济学院
阿拉善右	阿拉善右旗
喀纳斯	咯纳斯
玫琳凯	玫琳凯化妆品有限公司	marykay
宠物用品	宠物用具
兰大管院	兰大管理学院	兰州大学管理学院
沙捞越	sarawak
皮包	皮具店	皮包店	皮具
土星	saturn
富德科	freecom
新华	新华区
那不勒斯	naples
新化	新化县
牡医	牡丹江医学院
cnah	中国航空集团公司
内蒙机电职院	内蒙机电职业学院
江阴职院	江阴职业技术学院	江阴职业学院
河北联大	河北联合大学
金融管理学院	浦东金融管理学院
南京银行	bankofnanjing	南京银行股份有限公司	njcb
植村秀	shu-uemura	shuuemura
维克斯堡	vicksburg
保定职院	保定职业学院	保定职业技术学院
东北3门	东北三门
郓城	郓城县
南川	南川区
港大附属学院	香港大学专业进修附属学院
蒙巴萨	mombasa
濠江	濠江区
宣化	宣化区	宣化县
建平	建平县
中南大土建院	中南大土木建筑学院	中南大学土木建筑学院
陕西警官职院	陕西警官职业学院
阎良	阎良区
长岛	长岛县
三峡电力职院	三峡电力职业学院
蓬莱机场	蓬莱沙河口机场	沙河口机场
闽侯	闽侯县
南大	南开区	南京大学	南昌大学	南开	南通大学	南开大学
上指	上指学院	武警上海指挥学院	中国人民武装警察部队上海指挥学院
炮指	炮兵指挥学院	炮指学院	中国人民解放军炮兵指挥学院
白下	白下区
长治	长治市	长治县
德令哈	德令哈市
北方汽修	北方汽修学院
美溪	美溪区
中国美院	中国美术学院
伊斯坦布尔	istanbul
万州机场	五桥机场	重庆万州五桥机场
斯大林格勒	stalingrad
新余高专	新余高等专科学校
沈农高职院	沈阳农业大学高等职业技术学院
下花园	下花园区
三峡旅游职院	三峡旅游职业技术学院	三峡旅游职业学院
徐汇	徐汇区
皮山	皮山县
韶山	韶山市
民航飞行学院	中国民用航空飞行学院
人大培训学院	中国人民大学培训学院	人民大学培训学院	中国人大培训学院
福建财管干	福建财会管理干部学院	福建财管干学院
嵩明	嵩明县
大连港务学院	大连港务专修学院
东南9门	东南九门
武指郑州分院	中国人民武装警察部队指挥学院郑州分院	武警指挥学院郑州分院
施华蔻	schwarzkopf
南斯拉夫	yugoslavia	南斯拉夫联盟共和国
婺源	婺源县
右玉	右玉县
从江	从江县
中信学院	茂名中信专修学院
河南财专	河南财政税务高等专科学校	河南财税专科学校
宜章	宜章县
辽青干院	辽宁青年管理干部学院
伊技大	伊尔库茨克技术大学
山东政法	山东政法学院
锦州	锦州市
江苏海事职院	江苏海事职业学院	江苏海事职业技术学院
德化	德化县
惠科	hkc	鹰派
汕尾	汕尾市
万盛	万盛区
成都电机专科学校	成都电子机械高等专科学校	成都电子机械专科学校
海事局	中华人民共和国海事局	国家海事局	中国海事局
怀集	怀集县
职教基地	职业教育基地
墨西拿	messina
兴安职院	兴安职业技术学院	兴安职业学院
诸暨	诸暨市
类乌齐	类乌齐县
薪元按摩	吉林市薪元按摩培训学校
长春光华学院	长春大学光华学院
省人艺	四川省人民艺术学院
生科院	生命科学学院	生命学院	生命科学院
中青院	中国青年政治学院
德惠	德惠市
悉尼	sydney
逸仙学院	北京逸仙学院	北京逸仙专修学院
西南8门	西南八门
川医	川北医学院
周村	周村区
省招办	省招生办公室
流动学院	流动师资培训学院
安康	安康市
天门	天门市
禅城	禅城区
长工程	长春工程学院	长春工学院
马绍尔群岛	马绍尔群岛共和国	marshallislands
越南警院	越南人民警察学院
大众传媒学院	大众传媒职业技术学院
高教出版社	高等教育出版社
达纳	dana
青岛拓谱	青岛拓谱信息工程专修学院
陕西电力设计院	陕西省电力设计院
农科院土壤肥料研究所	中国农科院土壤肥料研究所
评剧院	评剧剧院
广东省纺织职院	广东省纺织职业技术学院	广东省纺织职业学院
老谷	老古
武工大邮电与信息工程学院	武汉工程大学邮电与信息工程学院
华阴	华阴市
高州	高州市
沈工大	沈阳工业大学	沈阳工大
广州现代信息工程职院	广州现代信息工程职业学院	广州现代信息工程职业技术学院
厦门医专	厦门医学高等专科学校	厦门医学专科学校
巴东	巴东县
高中	高级中学
萨嘎	萨嘎县
民宗厅	宗教事务厅	宗教厅	民族宗教事务厅	民族与宗教事务厅
馨乐庭	citadines
新闻出版总署	中国新闻出版总署	国家新闻出版总署	中华人民共和国新闻出版总署
铃木	铃木汽车	suzuk	suzuki	suzukimotor
银河学院	银河信息技术学院
江陵	江陵县
元符学院	元符珍品定制学院
同济医学院	华中科技大学同济医学院
江苏省盐务局	江苏省盐务管理局	江苏省盐管局
五一节	劳动节
森森孤学院	重庆森森孤学院
精防院	精神卫生防治院
厦门安防科技职院	厦门安防科技职业学院
中大思科网络学院	中山大学思科网络学院
组委	组织委员会	组委会
卢比肯	rubicon
象山	象山县	象山区
暑期学院	暑期哲学学院
学位委员会	国务院学位委员会
潞城	潞城市
秦职院	秦皇岛职业技术学院	秦皇岛职业学院
麦当劳	mcdonald	mcdonalds	mcdonald's
府谷	府谷县
潮州	潮州市
香特莉	香特莉chantilly	chantilly
崇义	崇义县
武汉语言文化职院	武汉语言文化职业学院
湖北交通职院	湖北交通职业学院	湖北交通职业技术学院
政法委	政法委员会
美宜家	美宜佳	美宜嘉
塔河	塔河县
思妍丽	decleor
佳大	佳木斯大学
成都	成都市
镇沅	镇沅县	镇沅自治县	镇沅彝族哈尼族拉祜族自治县
艺苗	艺苗舞蹈学院
忻州	忻州市
华电科技学院	华北电力科技学院	华北电力大学科技学院
宝山	宝山区
司法警官职院	河北司法警官职业学院
阿拉木图	almaata
伍家岗	伍家岗区
定南	定南县
大连医大中山学院	大连医科大学中山学院
福大	福州大学
奥里诺科河	otinoco
大兴	大兴区
浦发	上海浦东发展银行	上海浦东发展银行股份有限公司	浦发银行	浦东发展银行	上海浦发	shanghaipudongdevelopmentbank	spdb
河北建材职院	河北建材职业学院	河北建材职业技术学院
长炼职大	长岭炼油厂职工大学
开民电子电器	西安开民电子电器新技术应用研究所
安居	安居区
扬州工业职院	扬州工业职业学院	扬州工业职业技术学院
陇南	陇南市
静宁	静宁县
吴中	吴中区
贵阳护理职院	贵阳护理职业学院
固安	固安县
西安	西安区	西安市
道外	道外区
山东服装职院	山东服装职业学院
天山	天山区
萨里	surrey
石峰	石峰区
黑龙江物理研究所	黑龙江省科学院技术物理研究所
温大	温州大学
泉港	泉港区
色当	sedan
东宝	东宝区
四川南溪一中	四川省南溪县第一中学
邦达机场	昌都机场	昌都邦达机场
残协	残疾人协会
克山	克山县
南头机场	深圳南头直升机场
华商银行	chinesemercantilebank
狮子山	狮子山区
安徽审计学院	安徽审计职业学院
北戴河	北戴河区
卫星生物制品	辽宁卫星生物制品研究所
努瓦克肖特	nouakchott
宁明	宁明县
伟创力	flextronicsinternational
神童双语	魏县神童双语幼儿园
大荔	大荔县
浮梁	浮梁县
中石化	中国石化	sinopec	中国石油化工集团公司
番茄酱	蕃茄酱
荔湾	荔湾区
安徽中医专	安徽中医药高等专科学校	安徽中医药专科学校
长海机场	大长山岛机场	长海大长山岛机场
计生办	人口计生办	人口和计划生育办公室
马克西	maxi
环资委	环境与资源保护委员会	环境资源保护委员会
工商嘉华学院	工商大学嘉华学院
来安	来安县
西南9门	西南九门
通化	通化市	通化县
广东石化学院	广东石油化工学院
郑大体院	郑大体育学院	郑州大学体育学院
仁川	inchon	jinsen
哈尔滨	哈尔滨市
内乡	内乡县
西油	西安油大	西安石油大学	西油大学
定州	定州市
恩贾梅纳	ndjamena
高阳	高阳县
石家庄外语职院	石家庄外国语职业学院	石家庄外语职业学院
武汉科大中南分校	武汉科技大学中南分校
江苏经贸职院	江苏经贸职业学院
6区	六区
文安	文安县
河南建筑职院	河南建筑职业技术学院	河南建筑职业学院
枫溪二小	潮州枫溪第二小学	枫溪第二小学
济南工程职院	济南工程职业学院	济南工程职业技术学院
港教院	香港教育学院
雅普拉河	japura	apura
华南联大	华南联合大学
北京卓达学院	北京卓达经济管理学院	卓达经济管理学院	北京卓达经济学院	北京卓达经济管理研修学院
河北	河北区	河北省
阳原	阳原县
企策	企划	企业策划
岳塘	岳塘区
奥维亚多	oviedo
子长	子长县
民生银行	中国民生银行	chinaminshengbank	中国民生	cmbc	中国民生银行股份有限公司
行唐	行唐县
浙江农大天目学院	浙江农林大学天目学院
太和	太和区	太和县
人大法学院	人民大学法学院	中国人大法学院	中国人民大学法学院
湖北济管干	湖北省经济管理干部学院	湖北经济管理干部学院
扎鲁特	扎鲁特旗
箫山十一中	杭州市萧山第十一高级中学
玉环	玉环县
雷山	雷山县
迪阿吉奥	diageo
台江	台江区	台江县
资讯学院	资讯科学技术学院
指挥学院	广州指挥学院
元谋	元谋县
莲湖	莲湖区
北京科技职院	北京科技职业学院
玉州	玉州区
台交	台交大	台湾交通大学	台湾交大
北教院	北京教育学院
密苏里	missouri
临泉	临泉县
太湖	太湖县
新几内亚岛	newguinea
河池职院	河池职业学院
7中	第7中学	第七中学	七中
内华达山脉	sierranevada
南2门	南二门
武汉铁路职院	武汉铁路职业技术学院	武汉铁路职业学院
佛山	佛山市
端州	端州区
辽工大	辽宁工大	辽宁工技大	辽宁工程技术大学	辽宁工业大学
北站	客运北站	客运站北站	北客运站	北客站
门头沟	门头沟区
博山	博山区
竹山	竹山县
长春光机学院	长春光学精密机械学院
郑大工学院	郑州大学工学院
阿曼尼	giorgioarmani
萨拉曼卡	salamanca
惠农	惠农区
湖州电大	湖州广播电视大学
芙蓉园	芙蓉苑
西安工大北方信息工程学院	西安工业大学北方信息工程学院
山东交通职院	山东交通职业技术学院	山东交通职业学院
绩溪	绩溪县
朝阳科大	朝阳科技大学
兴隆台	兴隆台区
公安学院	公安职业学院	公安职院
北大信科院	北京大学信息科学学院	北大信息科学学院
伊犁	伊犁市	伊犁州	伊犁自治州	伊犁哈萨克自治州
广东市政	广东省市政工程协会
安庆	安庆市
泸州	泸州市
侨大厦门工学院	华侨大学厦门工学院
伊利	erie
沈航北方科技学院	沈阳航空工业学院北方科技学院
丁家宜	tjoy
民居	民宅
许昌	许昌市	许昌县
安丘	安丘市
昌吉	昌吉州	昌吉市	昌吉自治州	昌吉回族自治州
伊朗	iran	伊朗伊斯兰共和国
安桥	onkyo
华交	华东交大	华东交通大学	华交大
应技学院	应用技术学院
广东科学技术职院	广东科学技术职业学院
欧亚	西安欧亚	西安欧亚学院	欧亚学院
武都	武都区
河南公安专科学校	河南公安高等专科学校
帕西欧	paseo
北镇	北镇市
艾杜纱	ettusais
三宝	三宝堂
苏锦一小	苏州市苏锦第一小学
上海民远职院	上海民远职业技术学院	上海民远职业学院
美容会所	美容spa会所	美容美发会所
西电计算机学院	西安电子科技大学计算机学院
盐务局	盐务管理局	盐管局
鲁甸	鲁甸县
湖北生态工程职院	湖北生态工程职业学院	湖北生态工程职业技术学院
白沙	白沙县	白沙自治县	白沙黎族自治县
樊城	樊城区
白山	白山市
冷水江	冷水江市
秦安	秦安县
四川托普信息技术职院	四川托普信息技术职业学院
抚顺二中	抚顺市第二高级中学
浙江广厦建设职院	浙江广厦建设职业技术学院	浙江广厦建设职业学院
辽大	辽宁大学
长城	万里长城	greatwall
洪泽县共和镇卫生院	qinghaiuniversityaffiliatedhospital
房贷	住房贷款
长大工程学院	长江大学工程学院
山东	山东省
汉中职院	汉中职业学院	汉中职业技术学院
卫生站	卫生服务站	卫生室	卫生服务中心
古摄影	古摄影婚纱艺术影楼
舟山国际海运职院	舟山国际海运职业学院	舟山国际海运职业技术学院
东方馨艺花艺	亚太北京东方馨艺花艺培训中心
青华学院	西安青华专修学院
朋克	punk
夏恩英语	夏恩英语学院
新喀里多尼亚岛	newcaledonia
温江机场	成都温江机场
计算机学院	计算机科学学院
塔什库尔干	塔什库尔干自治县	塔什库尔干县	塔什库尔干塔吉克自治县
潜艇	潜水艇
理肤泉	laroche-posay	larocheposay	理夫泉
斯加那加	srinagar
托里	托里县
培佳双语学校	上海培佳双语学校
湖南人科院	湖南人科学院	湖南人文科技学院
阳光学院	福大阳光学院	福州大学阳光学院
中南财大武汉学院	中南财经政法大学武汉学院
徐工院	徐州工程学院	徐州工学院
孝义	孝义市
中延院	中青年干部培训班赴中国延安干部培训学院
开教院	开封教育学院
山艺	山东艺术学院
麦卡森	麦克森	mckesson
罗瓦涅米	rovaniemi
大新银行	大新银行(中国)有限公司	大新银行集团	dahsingbank	大新银行集团有限公司
环江	环江毛南族自治县	环江县	环江自治县
娄底电大	娄底广播电视大学
瓦萨	vaasa
台大	台湾大学
山西机电职院	山西机电职业技术学院	山西机电职业学院	山西机电职工学院
郑州航空管院	郑州航空工业管理学院
原州	原州区
广财	广财院	广西财经学院	广西财经	广西财经院
东营职院	东营职业学院	东营职业技术学院
沈医何氏视觉科学学院	沈阳医学院何氏视觉科学学院
廊坊职院	廊坊职业学院	廊坊职业技术学院
郑州	郑州市
武定	武定县
广博	上海市广博进修学院
筠连	筠连县
牡丹江师范	牡丹江师院	牡丹江师范学院
镇平	镇平县
洛杉矶	losangeles
马特拉	matra
镇坪	镇坪县
东方外院	东方外语职业学院
郑州煤干院	郑州煤炭管理干部学院
赞比亚	zambia	赞比亚共和国
哈密	哈密市	哈密地区
都彭	stdupont	st.dupont
武工院	中国人民武装警察部队工程学院	武警工程学院	武汉工业学院	武汉工学院
吉大外语学院	吉大外国语学院	吉林大学外国语学院
运河	运河区
媒体	传媒
宿迁职院	宿迁职业学院	宿迁职业技术学院
内江	内江市
黑龙江民族职院	黑龙江民族职业学院
呼图壁	呼图壁县
民宗委	民族宗教事务委员会	民族与宗教事务委员会	宗教委
绵阳艺术学院	川音绵阳艺术学院	四川音乐学院绵阳艺术学院
乡委	乡委员会	乡民委员会	乡乡民委员会	乡委会	乡乡委员会	乡乡委会	乡乡委
宁阳瓜菜研究所	宁阳县瓜菜研究所
复旦继教院	复旦大学继续教育学院	复旦继续教育学院
爱茉莉	amore
鹤岗	鹤岗市
京山	京山县
日派	ripai
太原科大华科学院	太原科技大学华科学院
园林局	园林绿化管理局	园林管理局	园林绿化局
南方翻译学院	四川外语学院重庆南方翻译学院
t6火锅	t6香辣火锅
淮北职院	淮北职业学院	淮北职业技术学院
金卡丁郡	kincardineshire
公安大学	中国人民公安大学	中国公安大学
马斯河	mass
高雄	高雄市	kaohsiung
黔西	黔西县
达坂城	达坂城区
密云	密云县
郑州师院	郑州师范	郑州师范学院
嘉兴南湖学院	嘉兴学院南湖学院
黄冈职院	黄冈职业学院	黄冈职业技术学院
电子科大成都学院	电子科技大学成都学院
霍林郭勒	霍林郭勒市
云城	云城区
菲利普莫里斯	philipmorris
北京天恩生物	北京天恩生物工程高新技术研究所
松江	松江区
度	°c	摄氏度	°
阿里	阿里市	阿历	阿里地区
白云机场	广州国际机场	白云国际机场	广州白云国际机场
漳州三中	福建省漳州市第三中学
传院	传播学院	吉林传播专修学院
黑龙江交通职院	黑龙江交通职业学院	黑龙江交通职业技术学院
队	分队
阿拉尔	阿拉尔市
准格尔	准格尔旗
苏州托普信息职院	苏州托普信息职业学院	苏州托普信息职业技术学院
萨迦	萨迦县
黄金机场	赣州黄金机场	赣州机场
泾阳	泾阳县
巴勒斯坦	巴勒斯坦国
通河	通河县
西1门	西一门
钦南	钦南区
水电站	水电电站
印制	印刷
江诗丹顿	v.constantin	vconstantin
济南职院	济南职业学院
奎文	奎文区
阳朔	阳朔县
重庆电子工程职院	重庆电子工程职业学院
塔拉瓦	tarawa
中亚学院	中亚区域经济合作学院
炮院	高炮学院	炮兵学院	中国人民解放军炮兵学院
韩亚银行	韩亚银行(中国)有限公司	hanabank	中国韩亚银行
春秋国旅	春秋国际旅行社
阿尔及利亚	阿尔及利亚民主人民共和国
余江	余江县
公卫学院	吉大公卫学院	北大公共卫生学院	吉大公共卫生学院	吉林大学公共卫生学院	北京大学公共卫生学院	公共卫生学院
湖北生物科技职院	湖北生物科技职业学院
桂林机场	桂林两江国际机场	两江国际机场	桂林国际机场	两江机场
丹东机场	浪头机场	丹东浪头国际机场	丹东国际机场	浪头国际机场
通海	通海县
天津医专	天津医学高等专科学校	天津医学专科学校
北科延庆分校	北京科技大学延庆分校
安庆医专	安庆医药专科学校	安庆医药高等专科学校
老河口	老河口市
捷迅	jnc
乌普萨拉	upsala
淇滨	淇滨区
温莎	windsor
沙市机场	荆州沙市机场	荆州机场
铁岭师专	铁岭师范高等专科学校	铁岭师范专科学校
空航	中国人民解放军空军航空大学	空航院	空军航空大学	解放军空军航空大学
汤原	汤原县
立崎	richtek
贵定	贵定县
交城	交城县
中农公管学院	中国农业公共管理学院
哥弟	girdear
天水	天水市
西京	西京大学
钦州	钦州市
昭平	昭平县
东丰	东丰县
龙游	龙游县
清原	清原县	清原自治县	清原满族自治县
东风	东风区
张家口职院	张家口职业学院	张家口职业技术学院
宁陵	宁陵县
也门	也门共和国	yemen
杭州水处理技术开发中心	国家海洋局杭州水处理技术研究开发中心
中国医大	中国医科大学	中国医科大
萝岗	萝岗区
黄山	黄山区	黄山市
清远	清远市
清苑	清苑县
西宁机场	西宁曹家堡机场	曹家堡机场
富平	富平县
首都师大科德学院	首都师范科德学院	首都师范大学科德学院
山东丝绸纺织职院	山东丝绸纺织职业学院
苏城	siouxcity
黑大	黑龙江大学
江西理工大应用科学学院	江西理工大学应用科学学院
九原	九原区
浙大医学院	浙江大学医学院
石家庄理工职院	石家庄理工职业学院
八宿	八宿县
杨园中心小学	常熟市杨园中心小学
北注协	北京注册会计师协会
奔驰	mercedesbenz	benz	mercedes-benz	梅赛德斯-奔驰中国
斯大林斯克	stalinsk
影驰	galaxy
共青团员	共青团团员
葛兰素史克	glaxosmithkline
北3门	北三门
国学院	中国国学院	国学学院
东方	东方市
意大利	italy	意大利共和国
萨斯奎汉	susquehanna
北京演艺学院	北京演艺专修学院
正定机场	正定国际机场	石家庄国际机场	石家庄机场	石家庄正定国际机场
万全	万全县
云师大	云南师大	云南师范大学	云南师范
长岭	长岭县
宿州职院	宿州职业技术学院	宿州职业学院
小莉影视	小莉影像馆
南大共青学院	南昌大学共青学院
金口河	金口河区
青浦	青浦区
博湖	博湖县
肇院	肇庆学院
麦登斯	麦登斯时尚连锁
科技师院	河北科技师范	河北科技师范学院
铜川职院	铜川职业学院	铜川职业技术学院
稷山	稷山县
中国贸促会	中国国际贸易促进委员会
墨江	墨江哈尼族自治县	墨江县	墨江自治县
海曙	海曙区
安森美	onsemi
指南针计算机学院	指南针职业培训学院
阳城	阳城县
吉隆坡	kualalumpur
商洛	商洛市
浙江体职院	浙江体育职业学院	浙江体育职业技术学院
csr	中国南车股份有限公司
10	第十	拾	no10	十	第10
石大科技学院	石河子大学科技学院
奥林巴斯	olympus
漳浦	漳浦县
塞尔扣克山	selkirk
植科院	植物科学院	植物科学学院
番禺建筑设计院	广州市番禺城市建筑设计院
新英格兰	newengland
仓山	仓山区
厂	股份公司	集团公司	有限公司	控股公司	有限责任公司	集团	股份有限公司	公司
安义	安义县
德国	germany	德意志联邦共和国
云大成教院	云南大学成人教育学院	云南大学成教院
万荣	万荣县
西部学院	西部高级职业培训学院
潍院	潍坊学院
oran	奥兰治河
司法部	中华人民共和国司法部	国家司法部	中国司法部
邵院	邵阳学院
塞西亚	scythia
福建农林大金山学院	福建农林大学金山学院
金肯职院	金肯职业技术学院	金肯职业学院
绍兴电大	绍兴广播电视大学
中小学生	中小学学生
饶平	饶平县
广西理工职院	广西理工职业学院	广西理工职业技术学院
东华纺织学院	东华大学纺织学院
辽源职院	辽源职业学院	辽源职业技术学院
桐城师专	桐城师范专科学校	桐城师范高等专科学校
厦门国际会展职院	厦门国际会展职业学院
宁波理工学院	浙大宁波理工学院	浙江大学宁波理工学院
沃灵顿	warrington
山大	山西大学	山东大学
清职院	清远职业学院	清远职业技术学院
北影	北京电影学院
武大	武汉大学
港大	香港大学
五大连池	五大连池市
广电影视管干学院	广播电影电视管干学院	广播电影电视管理干部学院
常州机场	奔牛机场	常州奔牛机场
baidu	北京百度网讯科技有限公司
白云	白云区
铁道部	中国铁道部	中华人民共和国铁道部	国家铁道部
呼职院	呼和浩特职业学院	呼和浩特职院	呼和浩特市职业学院
湖南师大体院	湖南师范大学体育学院
奈塞河	neisse
拉斯帕尔马斯	laspalmas
鹿邑	鹿邑县
永州职院	永州职业学院	永州职业技术学院
总参军事学院	总参谋部军事学院
松下	panasonic
曲阳	曲阳县
望谟	望谟县
麦哲伦海峡	megellan
峡大	三峡大学
北语	北京语言大学
武川	武川县
清华同方	tongfang	tsinghuatongfang	清华同方电脑
7小	七小	第七小学	第7小学
增城	增城市
卢布林	lublin
湄洲湾职院	湄洲湾职业技术学院	湄洲湾职业学院
仁安羌	yenangyaung
山东农管干	山东省农业管理干部学院	山东农管干学院
乌马河	乌马河区
中国保管干	中国保险管理干部学院
江西信息应用职院	江西信息应用职业技术学院	江西信息应用职业学院
依兰	依兰县
尼瓦	niva
abb	阿西布朗勃法瑞
沿河	沿河自治县	沿河县	沿河土家族自治县
帝国理工	帝国理工学院
毛院	毛泽东文学院
荔波	荔波县
丘北	丘北县
政务中心	政务审批中心	政务服务中心	政务审批服务中心	行政审批服务中心	行政服务中心	行政中心	行政审批中心
若羌	若羌县
独山	独山县
江苏天智	江苏天智众联游戏教育学院
吉大工商管理学院	吉林大学工商管理学院
呼民院	呼和浩特民院	呼和浩特民族学院
来宾	来宾市
浦北	浦北县
廉江	廉江市
南皮	南皮县
贵大科技学院	贵州大学科技学院
西航专修学院	西南航空专修学院
龟湖	龟湖镇
南平	南平市
南票	南票区
宜阳	宜阳县
庄河	庄河市
民办万博科技职院	民办万博科技职业学院
福鼎	福鼎市
国防科大	国防科技大学	中国人民解放军国防科学技术大学	国防科学技术大学
宝清	宝清县
京瓷	kyocera	京都陶瓷
永修	永修县
荔城	荔城区
泊头	泊头市
诺森伯兰	northumberland
汉阳	汉阳区
四川城市职院	四川城市职业学院
永兴	永兴县
连云港电大	连云港广播电视大学
四川大学网络学院	四川大学网络教育学院
居丽	居丽装潢
玛纳斯	玛纳斯县
昔阳	昔阳县
五十铃	isuzu
张掖	张掖市
四川信息职院	四川信息职业技术学院	四川信息职业学院
清华	清华大学	thu	tsinghuauniversity
醴陵	醴陵市
吉医	吉林医药学院
驻马店	驻马店市
山东聊城贸易学校	山东省聊城贸易学校
八公山	八公山区
艾默生电气	emersonelectric
北京戏曲学院	北京戏曲艺术职业学院	北京戏曲艺术学院	北京戏曲职业学院
首都银行	首都银行(中国)有限公司	中国首都银行
口才宝语商学院	苏州口才宝语商学院
国务院研究室
承德职院	承德职业学院
路桥	路桥区
吉艺	吉林艺术学院
山西青管干	山西青年管理干部学院	山西青管干学院
民权	民权县
霍州	霍州市
中等职院	中等职业技术学院	中等职业学院
嘎洒机场	西双版纳嘎洒国际机场	西双版纳国际机场	嘎洒国际机场	西双版纳机场
纽芬兰	newfoundland
泛泰	pantech
增院	增城学院
兰州交大博文学院	兰州交通大学博文学院
兰州电大	兰州广播电视大学
红旗	hongqi	红旗区
炎陵	炎陵县
汝城	汝城县
吉林工业职院	吉林工业职业技术学院	吉林工业职业学院
郑州文理学院	郑州文理专修信息工程学院
南海电大	南海广播电视大学
邵东	邵东县
河南交通职院	河南交通职业技术学院	河南交通职业学院
昭大	香港昭仁大学
科技部	中国科技部	中华人民共和国科学技术部	科学技术部	中国科学技术部	中华人民共和国科技部
臭氧杀菌	臭氧灭菌
省经干院	四川省经济干部学院
谢通门	谢通门县
南大网院	南京大学网络教育学院	南大网络教育学院	南大网络学院
玉泉	玉泉区
开平	开平市	开平区
林职院	林业学院	林业职业学院	林业职院
广商院	广东商院	广东商学院
白碱滩	白碱滩区
设计学院	设计培训学院
民宗局	宗教事务局	国家宗教事务局	民族宗教事务局	宗教局	民族与宗教事务局
深圳社科院	深圳市社会科学院
惠德培训	惠德培训学院
火葬场	火化场
宜都	宜都市
蒲江	蒲江县
河口	河口瑶族自治县	河口自治县	河口区	河口县
图尔	tours
定海	定海区
alibaba	阿里巴巴网络有限公司
蕉城	蕉城区
老干局	老干部管理局	老干部局
铁西	铁西区
崆峒	崆峒区
甘肃	甘肃省
首都电大	首都广播电视大学
申扎	申扎县
湖南生物机电职院	湖南生物机电职业技术学院	湖南生物机电职业学院
广东新安职院	广东新安职业学院	广东新安职业技术学院
tbs钢铁	上海天宝不锈钢有限公司
枣院	枣庄学院
响水	响水县
西街外语学校	西街外国语学校
上海电脑学校	上海电脑培训进修学院
挪威海	norwegiansea
新疆农大科学技术学院	新疆农业大学科学技术学院
希罗普郡	shropshire
雪松	ran
温宿	温宿县
城规进修学院	规划局指定上海市城市规划进修学院
山西戏剧职院	山西戏剧职业学院
乐购	tesco乐购	特斯科	tesco
儿发院	福建儿童发展学院
纽巴伦	newbalance
洛江	洛江区
东财管理专修学院	上海东方财富管理专修学院
格林服装学院	东莞市格林服装设计学院
济源职院	济源职业技术学院	济源职业学院
安徽公安职院	安徽公安职业学院
台前	台前县
兽医院	兽医医院
法国	lafrance	法兰西共和国
信访办	信访办公室
靖西	靖西县
房产局	住房保障与房产管理局	房地产管理局	住房保障和房地产管理局	房产管理局	住房保障和房产管理局	房管局	住房保障与房地产管理局	房产管理局与住房保障	房地产管理局与住房保障	房地产管理局和住房保障	房产管理局和住房保障
田林	田林县
越秀	越秀区
潍坊工商学院	潍坊工商职业学院	潍坊工商职院
园林所	园林绿化管理所	园林管理所	园林绿化所
和君	和君创业
贵州商专	贵州商业高等专科学校	贵州商业专科学校
东北门	东北门口
临朐	临朐县
大关	大关县
大观	大观区
阿富汗	afghanistan	阿富汗伊斯兰国
证监会	中国证监会	证监委员会	证券监督委员会	证券监督管理委员会	中国证券监督管理委员会	证监委
屯留	屯留县
cnmc	中国有色矿业集团有限公司
林学会	林学学会
雁江	雁江区
oki	冲电子
泉州	泉州市
东北4门	东北四门
通川	通川区
巴哈马	巴哈马联邦
安徽新东方烹饪	安徽新东方烹饪专修学院
和静	和静县
发电机组	发电机机组
洗浴	洗浴中心
上音	上海音乐学院
四川幼儿师专	四川幼儿师范高等专科学校	四川幼师专科学校
四川交通职院	四川交通职业学院	四川交通职业技术学院
奥塔戈	otago
错那	错那县
青云谱	青云谱区
投递	递送
国旅院	国旅学院	国际旅游学院
河南财经	河南财政大学	河南财经政法大学
江南	江南区
阳江机场	合山机场	阳江合山机场
武汉信息传播职院	武汉信息传播职业技术学院	武汉信息传播职业学院
天津轻工职院	天津轻工职业学院	天津轻工职业技术学院
江宁	江宁区
剑桥商业学院	剑桥商业管理学院
徽商职院	徽商职业学院
mhcb	瑞穗实业银行	mizuhocorporatebank
白水	白水县
北京农业职院	北京农业职业学院
鄂托克	鄂托克旗
武指南京分院	中国人民武装警察部队指挥学院南京分院	武警指挥学院南京分院
房产	地产	房地产
金川	金川县	金川区
中科	中科软件园
维思达	vct
兰溪	兰溪市
白塔	白塔区
湖南同德职院	湖南同德职业学院
极星	shehe
皮艇	皮划艇
岑巩	岑巩县
常州技师	常州技术师范	常州技术师范学院
皮肤病医院	皮肤病专科医院
广大	广西大学	广州大学
保定前卫路小学	河北省保定市前卫路小学
苍山	苍山县
西医院	西医医院
科尔沁艺术职院	科尔沁艺术职业学院
吉技师	吉林工程技术师范学院	吉林技术师范
纳巴达河	narbada
山农大	山西农业大学	山西农大	山东农业大学	山东农大
重庆水利电力职院	重庆水利电力职业学院	重庆水利电力职业技术学院
北京培黎大学	北京培黎职业大学
廊坊电大	廊坊广播电视大学
库伦	库伦旗
安卡拉	ankara
云农大	云南农业大学	云南农大
江苏畜牧兽医职院	江苏畜牧兽医职业技术学院	江苏畜牧兽医职业学院
集宁师院	集宁师范学院	集宁师范
望加西	macassar	makassar
马来亚	malaya
二工大	上海第二工业大学	二工业大学	第二工业大学	上海二工大
福建华南女子职院	福建华南女子职业学院
天津职技师大	天津职业技术师范大学
莱希	lacie
沈阳电大	沈阳广播电视大学
北港学院	青岛北港科技专修学院
柳州	柳州市
嘉兴规划设计院	嘉兴市规划设计研究院
奥亚克	oyak
色雷斯	thrace
黑山	montenegro	黑山县
蒙阴	蒙阴县
平顶山工业职院	平顶山工业职业技术学院	平顶山工业职业学院
石家庄法商职院	石家庄法商职业学院
阳江	阳江市
新航道	北京新航道学校
澜沧	澜沧县	澜沧拉祜族自治县	澜沧自治县
兰州师范	兰州师范学校
岚山	岚山区
糖葫芦	冰糖葫芦
金家庄	金家庄区
肇州	肇州县
哆拉a梦	多拉a梦	哆啦a梦	多啦a梦
埃尼	eni
东北6门	东北六门
人文大学	北京人文大学
北方外国语学院	鸡西北方外国语专修学院
绍兴文理元培学院	绍兴文理学院元培学院
石景山	石景山区
科技厅	科学技术厅
高要	高要市
市民大学	平镇市民大学
盖饭	盖浇饭
苏里南	surinam	苏里南共和国
永顺	永顺县
锡利群岛	scilly
红大	西北抗日红军大学
哥斯达黎加	哥斯达黎加共和国
法院	最高人民法院	中级法院	最高院	基层法院	基层人民法院	中级人民法院	高院	人民法院	高级法院	高级人民法院	中院	最高法院
双星	doublestar
交警队	交警支队	交通警察队	交通警察中队	交警中队	交警大队	交通警察大队	交通警察支队
盖世威	kswiss
白城	白城市
徐师大	徐州师大	徐州师范	徐州师范大学
印江	印江土家族苗族自治县	印江自治县	印江县
中医局	中医药管理局	中国中医药管理局	国家中医药管理局	中华人民共和国中医药局	中国中医药局	中华人民共和国国家中医药管理局	中华人民共和国中医药管理局	国家中医药局	中医药局	中医管理局
麻城	麻城市
张店	张店区
bab	b+ab	b&ab
微米	digilife
民航局	中国民用航空局
海南万和信息职院	海南万和信息职业学院	海南万和信息职业技术学院
江大网院	江大网络学院	江大网络教育学院	江南大学网络教育学院
仪陇	仪陇县
巴青	巴青县
内蒙古科技职院	内蒙古科技职业技术学院	内蒙古科技职业学院
共和	共和县
微蒙	wemo
民生信用卡	民生银行信用卡中心
消协	消费者协会
东北7门	东北七门
合肥共达职院	合肥共达职业技术学院	合肥共达职业学院
高州师院	高州师范学院	茂名高州师范学院	高州师范
阿尔斯特	ulster
宜春电大	宜春广播电视大学
察哈尔右翼中	察哈尔右翼中旗
长沙师院	长沙师范学校	长沙师范学院	长沙师范
高邑	高邑县
贵阳	贵阳市
兴隆	兴隆县
犍为	犍为县
梧州	梧州市
高岛屋	takashimaya
西安航空职院	西安航空职业技术学院	西安航空职业学院
彭州	彭州市
赫德岛和麦克唐纳岛
马里奥	mario
青云谱机场	南昌青云谱机场
鄂城	鄂城区
培英外语学校	天津培英外语试验学校
莫旗	莫力达瓦达斡尔族自治旗	莫力达瓦达斡尔族
复旦网院	复旦网络学院	复旦网络教育学院	复旦大学网络教育学院
宁波职院	宁波职业技术学院	宁波职业学院
文汇	文汇出版社
兰博基尼	蓝伯基尼	lamborghini	朗波吉尼
沙湾	沙湾区	沙湾县
党委	党支部委员会	党支部委	党支部	党支部委会	党委员会
西南4门	西南四门
石河子机场	石河子通用航机场
山西老区职院	山西老区职业学院	山西老区职业技术学院
林科大	中南林业科技大学	中南林科大	中南林业科大
张湾	张湾区
恒丰银行	evergrowingbank	恒丰银行股份有限公司
雅安职中	雅安职业高级中学
陕西科技学院	陕西渭南军地高科技学院
海工大	海军工程大学	中国人民解放军海军工程大学
岳普湖	岳普湖县
合阳	合阳县
永州	永州市
城大	香港城市大学
农安	农安县
红花岗	红花岗区
连云港机场	白塔埠机场	连云港白塔埠机场
保险职院	保险职业学院
纳尼顿	nuneaton
荃	荃^
雷敦	leyton
纪梵希	givenchy
宁夏	宁夏省	宁夏回族自治区
莹玉艺瓷	福建德化莹玉艺术陶瓷研究所
达拉斯	dallas
汝州	汝州市
渭南	渭南市
电白	电白县
左云	左云县
cfhi	中国第一重型机械股份公司
伦斯特	leinster
胜利遗尿病研究所	山西省运城市胜利遗尿病研究所
宁乡	宁乡县
东电	东北电大	东北电力大学	东电大
福比特	fpdzenec
萨那	san'a	sanaa	sana
大专院校	大专学校
沃特	voit
首都联大	首都联合职工大学
交通学院	山东交通学院
龙岩	龙岩市
语言文字工作	山东语言文字工作委员会
创新	creative
东山培正小学	广州市越秀区东山培正小学
锡尔河	syrdarja
麟游	麟游县
斐济	斐济共和国
诺华	novartis
雪铁龙	citroen
嘉模堂	嘉模堂^
广西革大	广西人民革命大学
诺顿湾	nortonsound
吉林交通职院	吉林交通职业技术学院	吉林交通职业学院
宁津	宁津县
莲花	lotus	莲花县
岱山	岱山县
湖南都市职院	湖南都市职业学院
贵州盛华职院	贵州盛华职业学院
重师大	重庆师大	重庆师范大学	重庆师范
西吉	西吉县
绍兴文理	绍兴文理学院
聊大	聊城大学
川师大计科	四川师范大学计算机科学学院
宝洁	广州宝洁有限公司	pg	p&g
上海中侨职院	上海中侨职业学院	上海中侨职业技术学院
闽江商学院	闽江学院新华都商学院
网达	wonda
振西学院	深圳振西科技商贸专修学院
广西师大出版社	广西师范大学出版社
安徽冶金科技职院	安徽冶金科技职业学院
检察官学院	检察官管理学院
腾冲机场	驼峰机场	腾冲驼峰机场
宜川	宜川县
上海医专	上海医药专科学校	上海医药高等专科学校	上海医药高等学校
山东理工学院	山东理工职业学院
玉佛寺	玉佛禅寺
绥芬河机场	绥芬河直升机货运机场
宜春	宜春市
微尔	viooo
玉树	玉树自治州	玉树县	玉树州	玉树市	玉树藏族自治州
福建体职院	福建体育职业学院	福建体育职业技术学院
阳新	阳新县
和政	和政县
克莱斯勒	chrysler
昌乐	昌乐县
遵义一中	贵州省遵义县第一中学
金寨电大	金寨县广播电视大学
辰熙	辰熙中英学校	辰熙中英文学校
开益学院	天津开益国际经贸专修学院
广西师大漓江学院	广西师范大学漓江学院
通榆	通榆县
河津	河津市
牡大	牡丹江大学
昌黎	昌黎县
中川机场	兰州中川机场	兰州机场
巴音郭楞职院	巴音郭楞职业学院	巴音郭楞职业技术学院
中途岛	midway
旗委	旗委会	旗委员会	旗旗委	旗旗委会	旗旗委员会
潍坊电大	潍坊广播电视大学
全聚德	北京全聚德烤鸭	全聚德烤鸭
蒙特利尔	montreal
质检中心	质量检测中心
西交城院	西安交通大学城市学院	西安交大城市学院
川师成都学院	川师大成都学院	四川师范大学成都学院
六枝特	六枝特区
襄垣	襄垣县
司法考试学院	政法大学司法考试学院	法大司法考试学院	中国政法大学司法考试学院	中国法大司法考试学院	中政大司法考试学院
基思利	keighley
冰淇凌	冰激凌	冰淇淋	冰激淋
农经委	农经委会	农村经济委员会
天津电子信息学院	天津电子职业信息技术学院
襄院	襄樊学院
烟山河	smokyhill
戴埠中心小学	溧阳市戴埠中心小学
长沙航空职院	长沙航空职业学院	长沙航空职业技术学院
陕西铁路工程职院	陕西铁路工程职业学院	陕西铁路工程职业技术学院
太原师院	太原师范	太原师范学院
江西共大	江西共产主义劳动大学
武穴	武穴市
新塘机场	湛江新塘机场
南充师院	南充师范	南充师范学院
斯克内克塔迪	schenectady
萧山	萧山区
名和堂	明和堂	明禾堂
松岭	松岭区
桃源	桃源县
经理认证管理办	中国电子商务协会职业经理认证管理办公室
公关学院	山东公共关系学院
西南5门	西南五门
乐山	乐山市
呼大	呼伦贝尔大学
巴布亚新几内亚	巴布亚新几内亚独立国
莫里郡	morayshire
广东法警职院	广东法警职业学院	广东司法警官职业学院
湘竹人家	香卒人家
卫生部	中国卫生部	中华人民共和国卫生部	国家卫生部
索马里兰	somaliland
丹凤	丹凤县
华北联大	华北联合大学
信工院	信工学院	信息工程学院
南1门	南一门
西北大	西北大学
厦门机场	厦门高崎国际机场	高崎国际机场	厦门国际机场	高崎机场
中江	中江县
预防腐败局	国家预防腐败局
昆仑	昆仑onweb	17kunlun
灌云	灌云县
常州电大	常州市广播电视大学
延安职院	延安职业学院	延安职业技术学院
浦口	浦口区
雨城	雨城区
浙海院	浙江海洋学院
俄勒冈	oregon
林干院	林业局管理干部学院
公积金	住房公积金	公积金中心	公积金管理中心	住房公积金管理中心
港闸	港闸区
普定	普定县
金东	金东区
烟大文经学院	烟台大学文经学院
安徽涉外学院	安徽涉外经济职业学院
兰山	兰山区
怀柔	怀柔区
宝格丽	bvlgari	宝嘉丽
沙竺阿拉伯	沙特阿拉伯王国
双辽	双辽市
老龄委	老龄工作委员会	老龄委会
怀仁	怀仁县
厦门电大	厦门市广播电视大学
什切青	stettin
苏大应用学院	苏州大学应用学院
盘算机学院	盘算机科学技能学院
马尼拉	manila
黏	粘
天津圣雪莲瑜伽	天津圣雪莲瑜伽学院
中国开放大学	中国远程开放大学
巍山	巍山彝族回族自治县	巍山县	巍山自治县
地科院	地科学院	地球科学学院	中国地质科学院
广东省轻工技师学院	广东省轻工业技师学院	广东轻工业技师学院
广技师	广东技术师范	广东技术师范学院
特古西加尔巴	tegucigalpa
河北工程技术专科学校	河北工程技术高等专科学校
潜山	潜山县
崇安机场	南平崇安机场	南平武夷山机场	武夷山机场	南平机场
皖医	皖南医学院
林周	林周县
桐乡	桐乡市
武指太原分院	中国人民武装警察部队指挥学院太原分院	武警指挥学院太原分院
浙江汽车职院	浙江汽车职业学院	浙江汽车职业技术学院
冶院	西安矿冶学院
新疆现代职院	新疆现代职业学院	新疆现代职业技术学院
gome	国美电器控股有限公司
壤塘	壤塘县
省科学院	山东省科学院
厨具	橱具
成信院	成都信息工程学院	成都信息学院
淮安电大	淮安广播电视大学
中工院	中原工学院
察哈尔右翼前	察哈尔右翼前旗
北京外语学院	北京外国语学院
河教院	河南教育学院
东北师范附小	东北师范大学附属小学	东北师范附属小学
顺平	顺平县
河北青管干	河北青年管理干部学院	河北青管干学院
基多	quito
石柱	石柱自治县	石柱县	石柱土家族自治县
派斯学院	重庆工商大学派斯学院
揭阳电大	揭阳广播电视大学
堆龙德庆	堆龙德庆县
乐昌	乐昌市
妇女节	三八节	三八妇女节
吕梁高专	吕梁高等专科学校
濉溪	濉溪县
成都宜家	成都宜家家居	宜家成都
农展	农业展览
贵港	贵港市
五河	五河县
翁布里亚	umbria
江城学院	中国地大江城学院	地质大学江城学院	地大江城学院	中国地质大学江城学院
钟山职院	钟山职业学院	钟山职业技术学院
杭州现代日语专修	杭州现代日语专修学校
景德镇	景德镇市
长沙电大	长沙广播电视大学
洛隆	洛隆县
西安汽车科技职院	西安汽车科技职业学院
唐院	唐山学院	唐山工学院
贝宁	贝宁共和国
南航金城学院	南京航空航天大学金城学院
兰州工专	兰州工业专科学校	兰州工业高等专科学校
撒哈拉	sahara
无棣	无棣县
宜宾共大	宜宾共产主义劳动大学
义乌工商职院	义乌工商职业学院	义乌工商职业技术学院
川菜	四川菜
莱比锡	leipzig
翔安	翔安区
羽西	靳羽西化妆品有限公司	yue-sai	yuesai
海德学院	上海海德继续教学学院
重庆巴渝职院	重庆巴渝职业学院	重庆巴渝职业技术学院
二道河子机场	长春二道河子机场
日立	日立集团	hitachi
sdb	深发展行	中国平安银行	深圳平安银行股份有限公司	深发行	深发展	平安银行	深圳发展银行	shenzhendevelopmentbank	深圳平安银行	深圳发展银行股份有限公司	深发展银行	pinganbank
中南林科院	中南林业科技学院
石家庄外翻学院	石家庄外语翻译职业学院	石家庄外语翻译学院
唐韵	greattang
国宾馆	国宾宾馆
喜马拉雅山脉	ximalaya
芝罘	芝罘区
永善	永善县
湖北中医专	湖北中医药高等专科学校	湖北中医药专科学校
菁华商业管理学校	沈阳菁华商业管理学校
松北	松北区
玛曲	玛曲县
阿尔山机场	伊尔施机场	阿尔山伊尔施机场
康佳	konka
大化	大化瑶族自治县	大化县	大化自治县
湖南信息科学职院	湖南信息科学职业学院
庆城	庆城县
保定电力职院	保定电力职业学院	保定电力职业技术学院
新安	新安县
兰州大学网络学院	兰州大学网络教育学院	兰大网络教育学院
老莫西饼	老莫九九西饼	老莫久久西饼	老莫99西饼
沅江	沅江市
审计学院	审计职业学院	审计职院
华师影视	华师武汉影视工程学院
万博学院	万博科技职业学院
北京十二中	北京市第十二中学
美宝莲	maybelline
西藏社科院	西藏社会科学院
默奇森河	murchison
浙江电力职院	浙江电力职业技术学院	浙江电力职业学院
水果之乡	herietta
鹤壁职院	鹤壁职业技术学院	鹤壁职业学院
卢本巴希	lubumbashi
土伦大学	土伦瓦尔大学
无极	无极县
太原创艺美术学校	太原创艺美术培训学校
北二外	北京第二外国语	北京第二外语学院	北京第二外国语学院	北京第二外国语大学
行知学院	浙江师大行知学院
信息学院	信息职业学院	信息职院
黔江	黔江区
重庆旅游学院	重庆师范大学旅游学院
叶城	叶城县
中大院	中国大连高级经理学院
无锡南洋职院	无锡南洋职业技术学院	无锡南洋职业学院
农商行	重庆农商行	农信社	农村信用合作社联合社	农村商业银行	农村信用合作联社	农商银行	农村信用社银行	重庆农村商业银行股份有限公司	chongqingruralcommercialbank	crcbank	农村信用合作社	农村合作银行	农村信用合作社联社	农村信用社	重庆农商银行	信用社	重庆农村商业银行	中国信合	农家合作银行
银海外语学院	运城学院银海外语学院
晋江	晋江市
内蒙古科大包头师范学院	内蒙古科技大学包头师范学院
太湖学院	江大太湖学院	江南大学太湖学院
咸宁职院	咸宁职业学院	咸宁职业技术学院
多维计算机培训	吉林多维计算机培训学校
天下	天下贰	天下二
汇丰商学院	北京大学汇丰商学院	北大汇丰商学院
马边	马边县	马边彝族自治县	马边自治县
厦大	厦门大学
西和	西和县
交口	交口县
通渭	通渭县
楚雄医专	楚雄医药专科学校	楚雄医药高等专科学校
鲁院	鲁迅文学院
新浦	新浦区
泉山	泉山区
南京化工职院	南京化工职业学院	南京化工职业技术学院
湖南公安专科学校	湖南公安高等专科学校
桐庐机场	桐庐直升机场
蓝天民航学院	陕西蓝天民航技术学院
芦淞	芦淞区
中洲国际	中洲国际培训学院
花王堂	花王堂^
石拐	石拐区
南8门	南八门
美伊娜多	menard
西湖	西湖区
石鼓	石鼓区
新招鲜	新招鲜餐饮连锁发展机构
新平	新平彝族傣族自治县	新平县	新平自治县
中国医科大临床医药学院	中国医科大学临床医药学院
成都华胜	成都华胜职业技能学校
随州	随州市
爱华学院	四川爱华学院
杜尔伯特	杜尔伯特蒙古族自治县	杜尔伯特自治县	杜尔伯特县
班玛	班玛县
四川水利职院	四川水利职业技术学院	四川水利职业学院
新市职教网	浙江省德清县新市职业高级中学
东丽	东丽区
台师大	台湾师大	台湾师范大学	台湾师范
格鲁吉亚	格鲁吉亚共和国
耕n	gainward
计生局	人口和计划生育局	人口计生局
麦什德	meshed
扶绥	扶绥县
合肥三联	合肥三联学院	安徽合肥三联学院
西4门	西四门
丞派	viewsun
美光	micron
南华工商学院	民办南华工商学院
甘霖营养学院	瀚翔甘霖营养学院	贵州瀚翔-甘霖营养学院
欧胜	wolfson
北关	北关区
海州	海州区
根河	根河市
淮北	淮北市
郑科院	郑州科技学院
树人学院	浙江树人学院
工农	工农区
美国	美利坚合众国	usa
青海卫生职院	青海卫生职业技术学院	青海卫生职业学院
贵州亚泰职院	贵州亚泰职业学院
美姑	美姑县
安国	安国市
伊兹密尔	izmir
西安交大医学院	西安交通大学医学院
鹤庆	鹤庆县
莫斯科人	moskovich
北安	北安市
九嶷职院	九嶷职业学院	湖南九嶷职业技术学院
体院	体育学院
营口职院	营口职业技术学院	营口职业学院
海珠	海珠区
蒙扎	monza
厦门会院	厦门国家会计学院
武指贵阳分院	中国人民武装警察部队指挥学院贵阳分院	武警指挥学院贵阳分院
南通纺织职院	南通纺织职业技术学院	南通纺织职业学院
万宁	万宁市
山西工商学院	山西工商职业技术学院	山西工商职业学院	山西工商职院
水电学院	水利水电学院
铜陵电大	铜陵广播电视大学
廊坊师院	廊坊师范	廊坊师范学院
曲沃	曲沃县
万里国际小学	宁波万里国际学校小学
万年	万年县
泰州二中	江苏省泰州市第二中学
从化	从化市
偃师	偃师市
浙林	浙江林大	浙江农大	浙江农业大学	浙江农林大学	浙林大	浙农大	浙农
资生堂	shiseido
北艺大	台北艺术大学
青海	青海省
浸大工商学院	香港浸会大学工商管理学院
江口	江口县
青大纺院	青岛大学纺织服装学院
勒芒	lemans
蓝科	landtek
哈商行	harbinbank	哈尔滨银行	哈尔滨市商业银行	hrbank
坟地	墓地
安联	alliianz
国资委	人民政府国有资产监督管理委员会	政府国有资产监督管理委员会	国有资产监督委员会	国有资产监管委员会	国有资产监督管理委员会	国务院国有资产监督管理委员会
云南锡业高等职院	云南锡业高等职业学院	云南锡业高等职业技术学院
师宗	师宗县
伊吾	伊吾县
巧家	巧家县
米粉肉	粉蒸肉
卢塞恩	lucerne
天农院	天津农学院
漳州卫生职院	漳州卫生职业学院
港中大	香港中文大学
兰州	兰州市
包头医学院	内蒙古科技大学包头医学院
德州职院	德州职业学院	德州职业技术学院
安龙	安龙县
匙	匙^
武警医学院	中国人民武装警察部队医学院
8	捌	no8	第八	第8	八	Ⅷ
河北经贸大学经管院	河北经贸大学经济管理学院
现代科技学院	太原理工现代科技学院	太原理工大学现代科技学院
北医	北大医学部	北京大学医学部
渤海大学成教学院	渤海大学成人教育学院
民大	中央民族大学	民族大学	中央民大	中民大
舟山电大	舟山广播电视大学
曲阜电大	山东广播电视大学曲阜学院
旌德	旌德县
南昌商院	江西农业大学南昌商学院	南昌商学院
十堰农科院	十堰市农业科学院
周四	星期四	礼拜四
礼仪学院	礼仪专修学院
山西水院	山西省水利水电勘测设计研究院
青河	青河县
静安	静安区
忻城	忻城县
住房城乡建设部	中国住房和城乡建设部	住房和城乡建设部	中华人民共和国住房和城乡建设部	国家住房和城乡建设部
减灾委员会	国家减灾委员会
茵宝	umbro
重庆交通职院	重庆交通职业学院
爱奥那岛	iona
东大出版社	东南大学出版社
洛阳市地税局	洛阳市地方税务局
下陆	下陆区
濮阳职院	濮阳职业技术学院	濮阳职业学院
福建林业职院	福建林业职业学院	福建林业职业技术学院
捷波朗	jabra
安徽体职院	安徽体育运动职业技术学院	安徽体育运动职业学院
哈尔滨理工大远东学院	哈尔滨理工大学远东学院
科摩罗	科摩罗伊斯兰联邦共和国
南谯	南谯区
久久臭氧	哈尔滨久久臭氧技术研究所
纳溪	纳溪区
句容	句容市
汉庭	汉庭快捷连锁酒店	汉庭快捷酒店	汉庭酒店	汉庭快捷	汉庭连锁快捷酒店	汉庭连锁酒店	汉庭连锁
杰克逊	jackson
松陵高级中学	苏州科技学院附中-松陵高级中学
bitway	清华紫光比威
羊城电大	羊城市广演电看大学
国交院	国际交流学院	四川外语学院国际文化交流学院	国交学院
陇西	陇西县
富豪	沃尔沃	volvo
友谊	友谊县
遵义师范	遵义师范学院	遵义师院
西建大	西安建筑科技大学	西安建科大学
长江农科院	长江流域农林科学院
云南经管院	云南经济管理职业学院	云南经济管理学院
山东科技职院	山东科技职业技术学院	山东科技职业学院
汉王	hanwang
南京体院	南京体育学院
碌曲	碌曲县
夏邑	夏邑县
合作	合作市
故城	故城县
中西结合医院	中西医结合医院
福海	福海县
绿田地植物研究所	河南漯河市绿田地植物研究所
人大国关学院	人大国际关系学院
伦敦雾	londonfog
上纽大	上海纽约大学
港澳办	国务院港澳事务办公室	国务院港澳事务办	国务院港澳办
福陆	fluor
成武	成武县
武夷山	武夷山市
襄樊理工	襄樊理工学院
夏津	夏津县
神农架	神农架林区
米东	米东区
lv	路易威登	路易・威登	louisvuitton
军交	军事交通学院	中国人民解放军军事交通学院	军交院
莱卡	lycra
妇保	妇女幼儿保健院	妇女儿童保健所	妇幼保健院	妇儿保健院	妇婴保健所	妇女儿童保健院	妇女幼儿保健所	妇女婴儿保健院	妇保所	妇保院	妇幼保健所	妇儿保健所	妇婴保健院	妇女婴儿保健所	妇保医院
浠水	浠水县
黑龙江信息技术职院	黑龙江信息技术职业学院
科尔沁右翼前	科尔沁右翼前旗
东城园林局	北京市东城园林局
摩托罗拉	摩托罗拉(中国)公司	motorola
尼康	nikon
西伯利亚	icematsiberian	siberia
湘西民族职院	湘西民族职业学院	湘西民族职业技术学院
郑州旅游职院	郑州旅游职业学院
齐齐哈尔师专	齐齐哈尔高等师范专科学校	齐齐哈尔师范专科学校
江西省林科院	江西省林业科学院
城中	城中区
合财	合肥财职院	合肥财经职业学院	安徽合肥财经学院	合肥财院	安财院	安徽财经	安徽财经大学	合肥财经学院	安财大学	安财	安徽财大
威克洛	wicklow
平顶山教院	平顶山教育学院
曼海姆	mannheim
吉州	吉州区
乌拉特中	乌拉特中旗
棉兰老	mindanao
东北1门	东北一门
马自达	mazda
新疆昌吉职院	新疆昌吉职业学院	新疆昌吉职业技术学院
四川中医专	四川中医药专科学校	四川中医药高等专科学校
连云港职院	连云港职业技术学院	连云港职业学院
吉县共大	吉县共产主义劳动大学
中邮网院	中国邮政网络培训学院
舟白机场	黔江机场	黔江舟白机场
省技校	广东省技术学院
山财中德学院	山西财经大学中德学院
葫芦岛七中	葫芦岛市第七初级中学
尼日尔	尼日尔共和国	niger
袁州	袁州区
邮大	邮电大学	北邮	北邮大	北京邮大	北京邮电大学
启东	启东市
杭州浦沿中学	浙江省杭州浦沿中学
浙江纺织服装职院	浙江纺织服装职业技术学院	浙江纺织服装职业学院
天津中德职院	天津中德职业学院	天津中德职业技术学院
湖北艺术职院	湖北艺术职业学院
档案局	国家档案局
昭通师专	昭通师范专科学校	昭通师范高等专科学校
江西中医专	江西中医药专科学校	江西中医药高等专科学校
柯坪	柯坪县
威信	威信县
马六甲	malakka
湖南电子科技职院	湖南电子科技职业学院
博士后科研站	晋江博士后科研工作站
玉田	玉田县
甘孜	甘孜州	甘孜市	甘孜藏族自治州	甘孜自治州	甘孜县
环保总局	国家环境保护总局	环境保护总局
文圣	文圣区
二道	二道区
天外滨海外事学院	天津外国语学院滨海外事学院
宁德	宁德市
前锋硬件学院	江西前锋硬件职业手艺学院
宜昌	宜昌市
东台	东台市
浙江工业职院	浙江工业职业学院	浙江工业职业技术学院
镶黄	镶黄旗
米林机场	林芝机场	林芝米林机场
秀洲现代实验	嘉兴市秀洲现代实验学校
武指长沙分院	武警指挥学院长沙分院	中国人民武装警察部队指挥学院长沙分院
富阳	富阳市
湖南水利水电职院	湖南水利水电职业技术学院	湖南水利水电职业学院
家乐福	carrefour
韦博培训学院	江西韦博职业技术培训学院
曲棍球场	曲棍球球场
成都电大	成都广播电视大学
老战士大学	西安老战友大学
利通	利通区
大道堂	北京大道堂中医养生研究院
隆化	隆化县
白云学院	广东白云学院
成都电大商学院	成都广播电视大学商学院
淄博科技职院	淄博科技职业学院
岳钟旗	岳钟琪
天津工管干	天津工管干学院	天津市工会管理干部学院
友利银行	wooribank	中国友利银行	友利银行(中国)有限公司
隆子	隆子县
郑州澍青医专	郑州澍青医学高等专科学校	郑州澍青医学专科学校
黎明职大	黎明职业大学	泉州黎明职业大学
马耳他	马耳他共和国
焉耆	焉耆自治县	焉耆回族自治县	焉耆县
龙胜	龙胜县	龙胜各族自治县	龙胜自治县
顺城	顺城区
田牛	田牛火锅
哈职院	哈尔滨职业技术学院	哈尔滨职业学院
长沙炮院	长沙炮兵学院
奥涅加湖	onega
千山	千山区
西科大	西南科技大学	西安科技大学	西南科大	西安科大
农工商职业技术学院	广东农工商职业技术学院
东北菜	东北家常菜	东北菜馆
帝汶	timor
西澳大学	西澳大利亚大学
杉达学院	上海杉达大学	上海杉达学院
霍尼韦尔	honeywell
丽柏	丽柏广场
瑞安	瑞安市
宝鸡文理	宝鸡文理学院
马来群岛	malayarchipelago
芦溪	芦溪县
姑苏人家	苏州人家
台盟	台湾民主自治同盟
马龙	马龙县
重庆足下软件职院	重庆足下软件职业学院
青岛求实文理学院	青岛求实文理专修学院
江理	江西理工	江西理工大学	江西理工大	江理大
金邦	geil
吴江	吴江市
人大常委	全国人民代表大会常务委员会	人大常务委员会	人民代表大会常委	中国人民代表大会常务委员会	人民代表大会常委会	中华人民共和国全国人民代表大会常务委员会	全国人大常委会	人大常委会	人民代表大会常务委员会
中霓会	中国广告协会霓虹灯广告委员会
金牛	金牛区
解放	解放区
亚运村第二幼儿园	北京市朝阳区亚运村第二幼儿园
广东省社科院	广东省社会科学院
昆理	昆明理工大	昆理大	昆明理工	昆明理工大学
退大	退休职工大学
六安	六安市
沁源	沁源县
捷波	jetway
阳泉职院	阳泉职业学院	阳泉职业技术学院
菲星数码	phisung
时装	衣服	衣服店	服装店	服装
泰山职院	泰山职业技术学院	泰山职业学院
披萨	匹萨	比萨
福瑞康正医药研究所	北京福瑞康正医药技术研究所
长沙国防大学	长沙国防科技大学
川民院	四川民族学院
索比顿	surbiton
广西	广西省	广西壮族自治区
物学院	终南山物学院
锦江	锦江区
普安	普安县
维哥	vigo
梓潼	梓潼县
开大	开封大学
正阳	正阳县
雅西	jassy
夏河	夏河县
里吉尔	ligier
乌兰乌德	ulan-ude
黑龙江粮食职院	黑龙江粮食职业学院
恭城	恭城瑶族自治县	恭城自治县	恭城县
江西科院	江西省科学院
佳华学院	上海佳华教育学院	上海佳华教育进修学院
东华进修学院	东华大学进修学院
特立尼达拉岛	trinidad
博尔塔拉	博尔塔拉市	博尔塔拉州	博尔塔拉自治州	博尔塔拉蒙古自治州
中怡数宽	dwnet
杨凌	杨凌区
育新实验幼儿园	北京育新实验幼儿园
山东中医药专	山东中医药专科学校	山东中医药高等专科学校
重庆工贸职院	重庆工贸职业学院	重庆工贸职业技术学院
青理	青理大	青岛理工	青岛理工大学	青岛理工大
黑龙江电大	黑龙江广播电视大学
图卢兹	toulousc
斯达康	utstar	utstarcom
陵水	陵水自治县	陵水县	陵水黎族自治县
3区	三区
罗耶尔	loyale
西乌珠穆沁	西乌珠穆沁旗
长顺	长顺县
撒瓦琪山脉	sawatchrange
精河	精河县
大兴安岭职院	大兴安岭职业学院
七喜	hedy
老边	老边区
集美成教院	集美大学成教学院	集美大学成人教育学院	集美大学成教院
扬州机场	扬州泰州机场
云南国防工业职院	云南国防工业职业技术学院	云南国防工业职业学院
深大法学院	深圳大学法学院
麦欧蛋	上海麦欧蛋糕房
海原	海原县
太子河	太子河区
科大网院	中国科学技术大学网络教育学院	科大网络教育学院	科大网络学院	中科大网络教育学院
西西里岛	sicily
堪萨市	kansas
园林办	园林办公室	园林绿化管理办公室
粤菜	广东菜
务川	务川县	务川自治县	务川仡佬族苗族自治县
峨眉山	峨眉山市	峨嵋山
黔南	黔南自治州	黔南布依族苗族自治州	黔南州	黔南市
面包店	面包房
昌吉职院	昌吉职业学院	昌吉职业技术学院
新华电脑学校	山东新华电脑学院
浙江同济科技职院	浙江同济科技职业学院
上街机场	郑州上街机场
马鞍山	马鞍山市
ccre	厦门海翼集团有限公司
罗湖	罗湖区
竺院	竺可桢学院
连州	连州市
泰安	tyan	泰安市
东乌珠穆沁	东乌珠穆沁旗
曲阜远东职院	曲阜远东职业技术学院	曲阜远东职业学院
高坪机场	南充高坪机场	南充机场
旺苍	旺苍县
下关	下关区
商丘职院	商丘职业学院	商丘职业技术学院
宜家南京	南京宜家家居	南京宜家
摩尔曼斯克	murmansk
芒康	芒康县
洛南	洛南县
旬阳	旬阳县
红安	红安县
安徽工贸职院	安徽工贸职业技术学院	安徽工贸职业学院
特信大	特区通信信息技术大学
浙江三联	浙江三联学院	浙江三联专修学院	三联专修	三联专修学院
兴平	兴平市
凯图颠峰	k2summit
张北	张北县
法兴	中国法国兴业银行	societegenerale	法国兴业银行	法国兴业银行(中国)有限公司
新左旗	新巴尔虎左	新巴尔虎左旗
浙经职大	浙江经济管理职工大学
泰顺	泰顺县
广东国防职大	广东省国防工业职工大学
广东青干院	广东青年干部学院
杏花岭	杏花岭区
洛宁	洛宁县
华文学院	青岛华文英豪语言专修学院
北京微电子研究所	北京微电子技术研究所
夏新	amoi
盖州	盖州市
宽城	宽城自治县	宽城县	宽城满族自治县	宽城区
山东胜利职院	山东胜利职业学院	山东胜利职业技术学院
维斯杜拉河	vistula
五台	五台县
秀洲	秀洲区
北京一七一中学	北京市第一七一中学
保时捷	porsche
缙云	缙云县
钦北	钦北区
莫仕	molex
华丰学院	华丰对外经济技术合作学院	华丰对外经济合作学院
至诚学院	福州大学至诚学院	福大至诚学院
欧姆尼	omni
神池	神池县
新郑电大	新郑广播电视大学
cgnu	商联保险
舰院	海军大连舰艇学院	大连舰院	中国人民解放军海军大连舰艇学院	大连舰艇学院	舰艇学院
沈丘	沈丘县
烟台汽车工程职院	烟台汽车工程职业学院
博物馆	博物院
匡威	converse
武汉新华电脑	武汉新华电脑专修学院
固原机场	六盘山机场	固原六盘山机场
民航总局	中国民用航空总局
集贤	集贤县
亚太机场	海南亚太机场
资院	资源学院
卡布奇诺	卡布其诺
海飞丝	shouldhead	should&head
资源	资源县
奇台	奇台县
广西师院师园学院	广西师范学院师园学院
雷肯	leiken
山东济北中学	山东省济北中学
九江职院	九江职业学院	九江职业技术学院
ysl	yvessaintlaurent	圣罗兰	伊夫圣罗兰
景电管理局	甘肃省景电管理局
肇源	肇源县
五十铃汽车	isuzumotors
江苏教育考试院	江苏教育考试学院
河南省农科院	河南省农业科学院
黑龙江农垦农业职院	黑龙江农垦农业职业学院	黑龙江农垦农业职业技术学院
贮藏	储藏
达茂旗	达尔罕茂明安联合旗	达尔罕茂明安联合
武汉工程职院学院	武汉工程职业学院学院	武汉工程职业技术学院学院
宁波电大	宁波广播电视大学
新宁	新宁县
南阳医专	南阳医学高等专科学校	南阳医学专科学校
光山	光山县
郧医药护学院	郧阳医学院药护学院
杜克	skinceuticals
政大	政治大学
周六杂学	周六民办杂志大学
浙商大商学院	浙江工商大学杭州商学院
内蒙古电子信息职院	内蒙古电子信息职业学院	内蒙古电子信息职业技术学院
苏州工艺美院	苏州工艺美术职业技术学院
伊工大	伊尔库茨克工大	伊尔库茨克工业大学
南艺大	台南艺术大学
加纳	加纳共和国
浙江第二师范	浙江第二师院	浙江第二师范学院
阿美尼亚	armenia
电大	广播大学	广播电视大学	电视广播大学	华电	电力大学	华北电力大学	华北电力	华北电大	电视大学
黔南民族师范	黔南民族师范学院	黔南民族师院
威远	威远县
东南3门	东南三门
四川电大	四川广播电视大学
东平	东平县
明达职院	明达职业技术学院	民办明达职业技术学院
布尔津	布尔津县
灵璧	灵璧县
柬埔寨	kampuchea	柬埔寨王国	cambodia
洪泽	洪泽县
义乌	义乌市
上海大	上海海洋大学
平川	平川区
阳谷	阳谷县
雷波	雷波县
长春生物研究所	长春生物制品研究所
东坡	东坡区
孟村	孟村县	孟村回族自治县	孟村自治县
珠海	珠海市
连江	连江县
广东二师院	广东第二师范学院
调兵山	调兵山市
萨格勒布	zagreb
包头职院	包头职业技术学院	包头职业学院
沈阳农大科学技术学院	沈阳农业大学科学技术学院
妇联	妇女联合会
黔西南	黔西南市	黔西南州	黔西南自治州	黔西南布依族苗族自治州
浦城	浦城县
上城	上城区
鲁艺	鲁迅艺术文学院
淮阴师范学院附属小学	淮安市淮阴师范学院附属小学
北京信息职院	北京信息职业技术学院	北京信息职业学院
那瓦拉	navarre
旗玛	qima
河工	南京理工	北京理工大学	南京理工大	哈工业大学	南京理工大学	武汉理工大学	河北工业大学	北方工业大学	华工	太原理工大	南京工业大学	北京工业大学	哈尔滨工大	河工大	西北工业大学	南理	南理工	大工	华中理工大学	理工大学	西安工大	武理	浙江工大	北理	河北工大	安徽工业大学	安工大	大连理工大学	解放军理工大学	工业大学	北工大学	理工大	大工大学	北理工	浙工大	北京工大	北工大	北京理工	北工	华南理工大	安徽工大	华中理工	西工大	北方工大	太原理工大学	武汉理工大	西工区	华东理工	浙江工业大学	工大	大连理工	华中理工大	西安工程大学	北京理工大	武汉理工	哈工程	安工	合肥工业大学	河工大学	西北工大	哈工程大学	华理	太工	大连工业大学	河南工业大学	合工大	河工程	华理工	南工大	太原理工	大理工	浙工大学	武工	哈尔滨工程大学	浙工	合工大学	南工	哈工	哈工大	合肥工大	南京工大	安徽工程大学	河南工大	华东理工大学	大工大	武理工	华南理工	西工	河北工程大学	合工	安工大学	华东理工大	工程大学	哈尔滨工业大学	中国人民解放军理工大学	大连工大	理工	西安工业大学	哈工大学	大连理工大	太理	西工大学	华南理工大学	太理工	南工大学
三原	三原县
赞皇	赞皇县
三门峡	三门峡市
三元	三元区
莆田	莆田市
普利斯通	bridgestone
始兴	始兴县
江西传媒学院	江西传媒学院专修学院
酷狗	kugou
包头铁道职院	包头铁道职业学院	包头铁道职业技术学院
高明电大	高明市广播电视大学
海洋局	国家海洋局
信物院	信息物理学院	信物学院
卢旺达	rwanda	ruanda	卢旺达共和国
东南1门	东南一门
弋江	弋江区
梓洲花苑	梓洲花园
尚德实验学校	上海尚德实验学校
余庆	余庆县
太仓	太仓市
陆院	石家庄陆军学院
黑龙江建筑职院	黑龙江建筑职业学院	黑龙江建筑职业技术学院
袁师傅	咸阳袁师傅腊汁肉夹馍
华西公卫	华西公共卫生学院
细河	细河区
河源	河源市
福建农业职院	福建农业职业学院	福建农业职业技术学院
福建外经贸学院	福建对外经济贸易职业技术学院
重交	重交大	重庆交大	重庆交通大学
利辛	利辛县
佛山机场	沙堤机场	佛山沙堤机场
商河	商河县
宁城	宁城县
蒙迪欧	mondeo
泰州师专	泰州师范专科学校	泰州师范高等专科学校
阳泉学院	太原理工大学阳泉学院	太原理工大阳泉学院
昌宁	昌宁县
坦佩雷	tampere
军委	中央军事委员会	中央军委	中华人民共和国中央军事委员会
刚果	刚果共和国
安溪	安溪县
晴隆	晴隆县
吴桥	吴桥县
朗讯	lucent
中牟	中牟县
渥太华	ottawa
马瑙斯	manaus
淮阴	淮阴区
鄂伦春	鄂伦春自治旗
西北师大附中	西北师范大学附属中学
外经贸商学院	对外经济贸易大学国际商学院
乌鲁木齐	乌鲁木齐县	乌鲁木齐市	urumqi
甘肃电大	甘肃广播电视大学
惠阳高级中学	广东惠阳高级中学
海飞	北京航空航天大学飞行学院	海军飞行学院	中国人民解放军海军飞行学院	飞行学院	北航飞行学院
慈利	慈利县
西弗吉尼亚	westvirginia
中加双语学校	马鞍山中加双语学校
仙游	仙游县
乐亭	乐亭县
湖南商职院	湖南商务职业学院	湖南商务职业技术学院
麦积	麦积区
乐途	lotto
澳洋实业	澳洋集团
夹江	夹江县
凤阳	凤阳县
镇江市专科学校	镇江市高等专科学校
美兰机场	海口国际机场	海口美兰国际机场	海口机场	美兰国际机场
青冈	青冈县
内蒙古电大人文学院	内蒙古广播电视大学人文学院
白银	白银市	白银区
中宁	中宁县
福建政管干	福建省政法管理干部学院	福建政管干部学院
武汉工贸职院	武汉工贸职业学院
南洋机场	盐城南洋国际机场	盐城国际机场	盐城机场	南洋国际机场
松潘	松潘县
南科大	南方科技大学	南方科大
武汉工学院工商学院	武汉工业学院工商学院
怀远	怀远县
理发店	理发馆
江西生物科技职院	江西生物科技职业学院
金昌	金昌市
马尔森	mulsanne
海蓝之谜	lamer
青岛酒店管理	青岛酒店管理学院
牙防院	牙病防治院
新韩银行	新韩银行(中国)有限公司	shinhanbank	中国新韩银行
广州华立科技职院	广州华立科技职业学院
甘肃政法	甘肃政法学院
北马里亚纳	北马里亚纳自由联邦
化隆	化隆县	化隆自治县	化隆回族自治县
smic	中芯国际集成电路制造有限公司
长洲	长洲区
湖南科技工业职院	湖南科技工业职业技术学院	湖南科技工业职业学院
奥斯特拉发	ostrava
巩义市科协	巩义市科学技术协会
江南艺术职院	江南艺术职业学院
一哥火锅	一哥肥牛火锅海鲜酒家	一哥火锅海鲜酒家	一哥海鲜火锅	一哥肥牛火锅
丹徒	丹徒区
匈牙利	匈牙利共和国
湖南师大树达学院	湖南师范大学树达学院
石家庄工商职院	石家庄工商职业学院
计算机系	清华计算机系	清华大学计算机系
八一节	八一建军节
中北学院	南师大中北学院	南京师范大学中北学院
大同职院	大同职业技术学院	大同职业学院
中信嘉华银行	citickawahbank
罗平	罗平县
山大网院	山大网络教育学院	山东大学网络教育学院
综治委	社会治安综合治理委员会	综治委会
大连轻工学院	大连轻工业学院	大连工业学院
黎平	黎平县
济大	济南大学
嵊州	嵊州市
柔美娜	ipsaipsajuven
炎黄职院	炎黄职业学院	炎黄职业技术学院
霞浦	霞浦县
安徽服装学院	安徽服装专修学院
爱辉	爱辉区
五营	五营区
咸阳职院	咸阳职业学院	咸阳职业技术学院
农林科学院	北京市农林科学院
密西根学院	上海交通大学密西根学院	交大密西根学院
四川华新现代职院	四川华新现代职业学院
优派	viewsonic
武城职	武城职院	武汉城市职业学院
城固	城固县
邹城	邹城市
柳州城市职院	柳州城市职业学院
北京电大	北京广播电视大学
城管	城市管理行政执法局	城市管理综合执法局	城管行政执法局	城管局	城市管理局	城管执法局
城关	城关区
史学会	史学学会
鞍山机场	腾鳌机场	鞍山腾鳌机场
扬州	扬州市
牛津郡	oxfordshire
吉木乃	吉木乃县
黑龙江煤炭职院	黑龙江煤炭职业学院	黑龙江煤炭职业技术学院
中国教育部国际司美大处	中国教育部国际司美洲与大洋洲事务处
蒙特塞拉特	montserrat
芙蓉	芙蓉区
改则	改则县
丰源包子铺	风缘包子铺
广州科技职院	广州科技职业技术学院	广州科技职业学院
温尼伯	winnipeg
镇委	镇镇委会	镇委会	镇委员会	镇镇委员会	镇镇委
主旨电大	主旨广播电视大学
连城机场	冠豸山机场	龙岩机场	连城冠豸山机场	龙岩冠豸山机场
涟源	涟源市
民委	中国国家民委	民委会	民族事务委员会	中国国家民族事务委员会	国家民委	中华人民共和国国家民族事务委员会	中华人民共和国国家民委
娄底职院	娄底职业技术学院	娄底职业学院
阜新	阜新市	阜新蒙古族自治县	阜新县	阜新自治县
普纳思金融	普纳思金融经济研究院
拉古娜	laguna
全创院	全球创业发展学院
安达曼岛	southandaman
清华继教院	清华大学继续教育学院	清华继续教育学院
百事	pepsico	pepsi
遵义职院	遵义职业技术学院	遵义职业学院
石阡	石阡县
厦门科技学院	厦门科技专修学院
马略尔卡岛	majorca
希腊	希腊共和国
辽宁机电职院	辽宁机电职业技术学院	辽宁机电职业学院
巴林	bahrain	巴林国
千岛群岛	thousandislands
治多	治多县
宁德职院	宁德职业学院	宁德职业技术学院
成都农业科技职院	成都农业科技职业学院
贝劳	贝劳共和国
吉水	吉水县
奉贤电大	上海奉贤电视大学
体改委	经济体制改革委员会
安徽国防科技职院	安徽国防科技职业学院
瓦加杜古	ouagadougou
兴仁	兴仁县
特爱	上海特爱外语进修学院
临澧	临澧县
西斯科	sysco
齐大	齐齐哈尔大学	齐鲁大学
阜新高专	阜新高等专科学校
广东水利电力职院	广东水利电力职业技术学院	广东水利电力职业学院
天科大	天津科大	天津科技大学
罗庄	罗庄区
安耐克	aneca
中国人寿	中国人寿保险
牙克石	牙克石市
松溪	松溪县
鹿岛建设	kajima
阿荣	阿荣旗
榆阳	榆阳区
平原	平原县
南大职业培训学院	南方医科大学南大职业培训学院
雀巢	nestle	nestlé
安徽电大	安徽广播电视大学
路北	路北区
贵州社院	贵州社会主义学院
圣保罗	saopaulo
洛浦	洛浦县
海浪机场	牡丹江机场	牡丹江海浪机场
古德坊	古德坊客栈
罗技	logitech
荷兰	netherlands	荷兰王国
国务院	中央人民政府
泰山	泰山区
长乡学院	长乡研修学院
温岭	温岭市
滕州电大	滕州广播电视大学
凭祥	凭祥市
江夏学院	福建江夏学院
安徽职院	安徽职业学院	安徽职业技术学院
海口经院	海口经济学院
奉新	奉新县
大方	大方县
洪洞	洪洞县
吉林建工学院城建学院	吉林建筑工程学院城建学院
四川理工	四川理工学院
隆阳	隆阳区
茄子河	茄子河区
家庭大学	中原区家庭发展大学
瑞昌	瑞昌市
电监会	电力监管委员会	国家电力监管委员会
黑龙江旅游职院	黑龙江旅游职业学院
临平职业中学	杭州临平职业高级中学
射阳	射阳县
永和	永和县
外贸大学	西安外贸职工大学
玉龙	玉龙纳西族自治县	玉龙县	玉龙自治县
山东传媒职院	山东传媒职业学院
龙泉	龙泉市
雅职院	雅安职业技术学院	雅安职业学院
大丰	大丰市
勤奋外国语学校	温州市勤奋外国语业余学校
贵港电大	贵港市广播电视大学
青大医学院	青海大学医学院	青岛大学医学院
台湾	台湾省
上饶	上饶市	上饶县
北4门	北四门
芗城	芗城区
武汉电力职院	武汉电力职业学院	武汉电力职业技术学院
湖南网络工程职院	湖南网络工程职业学院
南约克郡	southyorkshire
陕西电子信息职院	陕西电子信息职业技术学院	陕西电子信息职业学院
桂林旅专	桂林旅游高等专科学校	桂林旅游专科学校
红原	红原县
宁远	宁远县
特里尔	trier
沈建大	沈阳建筑大学
蓬溪	蓬溪县
泰塞德	tayside
高邮	高邮市
三亚理工职院	三亚理工职业学院
思明	思明区
哈尔滨科学技术职院	哈尔滨科学技术职业学院
广州市政设计研究院	广州市市政工程设计研究院
宁陕	宁陕县
山西管理职院	山西管理职业学院
岳阳	岳阳县	岳阳市
政和	政和县
淮阴师院	淮阴师范	淮阴师范学院
阿坝	阿坝自治州	阿坝县	阿坝藏族羌族自治州	阿坝州	阿坝市
新罗	新罗区
大阪	osaka
斯洛文尼亚	斯洛文尼亚共和国
常熟电大	常熟广播电视大学
西电研究生院	西安电子科技学院
丰台第二中学	北京市丰台区丰台第二中学
穆萨拉峰	musala
北大数院	北大数学科学学院	北京大学数学科学学院
设拉子	shiraz
郴州师专	郴州师范高等专科学校	郴州师范专科学校
平度	平度市
喜德	喜德县
舟山	舟山市
腾达	tenda
和田	和田市	和田县	和田地区
房产权	房产产权
黄岩	黄岩区
山东医专	山东医学专科学校	山东医学高等专科学校
思茅	思茅区
烈山	烈山区
常德职院	常德职业学院	常德职业技术学院
北印	北京印刷学院	印刷学院
武汉商服院	武汉商业服务技术学院
石狮幼儿园	石狮市幼儿园	石狮市多彩艺术幼儿园
重庆江北中学	重庆市江北中学校
北大出版社	北京大学出版社
安捷伦	agilent
子洲	子洲县
东宁	东宁县
园湖路小学	广西南宁市园湖路小学
北外	外语大学	外国语大学	上海外语大学	北京外国语大学	北京外国语	上外	上海外国语大学	上海外国语	北京外语大学
马刀	lesabra
武指呼和浩特分院	中国人民武装警察部队指挥学院呼和浩特分院	武警指挥学院呼和浩特分院
mv	mtv
云南法警职院	云南法警职业学院	云南司法警官职业学院
ms	microsoft中国	microsoft	微软(中国)有限公司
徐州建筑职院	徐州建筑职业技术学院	徐州建筑职业学院
淄博职业学院	淄博职业技术学院
元宝	元宝区
潞安职院	潞安职业学院	潞安职业技术学院
旁门	旁门口
茂港	茂港区
seereals	贵州西瑞科技有限公司
桔色	橘色
东北农大成栋学院	东北农业大学成栋学院
郧西	郧西县
辽宁美院	辽宁美术职业学院
北海机场	福成机场	北海福成机场
北京农业职院清河分院	北京农业职业学院清河分院
北票	北票市
南昌师专	南昌师范专科学校	南昌师范高等专科学校
沅陵	沅陵县
北京嘉华学院	北京工商大学嘉华学院	北京工商嘉华学院
云南刊联大	云南农村经济刊授联合大学
裕安	裕安区
约旦	jordan	约旦哈希姆王国
坦比科	tampico
gaode	高德软件有限公司
华光摄影艺术职业学院	泉州华光摄影艺术职业学院
润亚尼峰	rindjain
鄂尔多斯	鄂尔多斯市
园林队	园林绿化队
阿巴嘎	阿巴嘎旗
乡城	乡城县
益特施	ytshnesp	ytsh
昆医海源学院	昆明医学院海源学院
郑州电子信息职院	郑州电子信息职业学院	郑州电子信息职业技术学院
长沙	长沙县	长沙市
孟连	孟连傣族拉祜族佤族自治县	孟连县	孟连自治县
上海欧华职院	上海欧华职业学院	上海欧华职业技术学院
老城	老城区
中旅社	中国旅行社
市政工程中心	市政工程管理中心
朔州	朔州市
海医	海南医学院
宿迁师院	宿迁师范	宿迁师范学院
尉氏	尉氏县
安道尔	安道尔公国
苏家屯机场	沈阳苏家屯红宝山机场	苏家屯红宝山机场
广宗	广宗县
浙师大	浙江师大	浙江师范大学	浙江师范
英豪教育进修学院	上海英豪教育进修学院
华池	华池县
塞夫勒	sevres
前程无忧	51job
宣威	宣威市
陵川	陵川县
城厢一小	太仓市城厢镇第一小学
滨江	滨江区
山东商院	山东商学院	山东工商学院
修文	修文县
商丘电大	商丘广播电视大学
西航职大	航空职工大学	西安航空职工大学
山西煤干院	山西煤炭管理干部学院
莲大	莲庵畜产园艺大学
清华法学院	清华大学法学院
海淀	海淀区
落雁女大	落雁女子大学
青科大	青岛科大	青岛科技大学
海地	海地共和国
修武	修武县
精卫中心	精神卫生中心
海德	hedss
雅多维尔	jadotville
乡宁	乡宁县
实验学院	工大实验学院	北京工业大学实验学院
山西农大信息学院	山西农业大学信息学院
湖工商贸学院	湖工大商贸学院	湖北工业大学商贸学院
应城	应城市
山东信息职院	山东信息职业学院	山东信息职业技术学院
东北工大	东北工人政治大学
机动车	机动车辆
固阳	固阳县
瓦尔代高地	valdaihills
凤翔	凤翔县
株洲	株洲市	株洲县
青海交通职院	青海交通职业学院	青海交通职业技术学院
莱州农科院	莱州市农业科学院
西北5门	西北五门
江华	江华瑶族自治县	江华县	江华自治县
华科大文华学院	华中科技大学文华学院	华中科技大文华学院	华中科大文华学院
新合城	新合城酒楼
安图	安图县
浸大	香港浸会大学
台州科技职院	台州科技职业学院
舒兰	舒兰市
塔林	tallin
石家庄科技信息职院	石家庄科技信息职业学院
计算机函授	中国计算机函授学院
依泉	uriage
曾都	曾都区
榆次	榆次区
财务学院	上海财务管理进修学院
宽甸	宽甸自治县	宽甸县	宽甸满族自治县
资中	资中县
飞鱼星	volans
汾西	汾西县
广东电子技校	广东省电子技术学校
柳州医专	柳州医学专科学校	柳州医学高等专科学校
九台	九台市
抗院	抗战学院	太行抗战建国学院
北京汇佳学院	汇佳职业学院	北京汇佳职业学院
大保罗	saintbarbara
屯村实验小学	江苏省吴江市屯村实验小学
文艺学院	江西文化艺术学院
揭东	揭东县
纳苏	nsu
湖南理工南湖学院	湖南理工学院南湖学院
西安联合学院	西安联合职业培训学院
傲丽	covermark
星河学院	汕头星河专修学院
天津城建学院	天津城市建设学院
波密	波密县
顺昌	顺昌县
荆州职院	荆州职业学院	荆州职业技术学院
招远	招远市
孙吴	孙吴县
秀峰	秀峰区
信科院	信息科学院	信息科学学院
丛台	丛台区
河北省艺术职院	河北省艺术职业学院
山西电大	山西广播电视大学
燕大	燕山大学	燕京大学
南通科技进修学院	科技人员进修学院	南通市科技人员进修学院
祁东	祁东县
民乐	民乐县
湖南城院	湖南城市学院
中华易经大学	中华民族易经社会教育大学
城口	城口县
庄浪	庄浪县
通达国际海运	潍坊通达国际海运职业学校
新绛	新绛县
高青	高青县
塔大	塔里木大学
汕头机场	外砂机场	汕头外砂机场
纳米比亚	纳米比亚共和国	namibia
门	号门	门口
赫山	赫山区
福州软件职院	福州软件职业学院	福州软件职业技术学院
西安外语大学	西安外国语大学
石家庄电大	石家庄广播电视大学
万安	万安县
成都技师学院	成都市技师学院
深圳职院	深圳职业学院	深圳职业技术学院
吉首	吉首市
罗田	罗田县
湖南交通工程职院	湖南交通工程职业学院	湖南交通工程职业技术学院
厦华	xoceco
石狮科协	石狮市科学技术协会
丸美美容	广州市丸美美容美发职业培训学校
国家汉办	国家汉语国际推广领导小组办公室	国家对外汉语教学领导小组办公室	国家汉语国际推广领导小组	中国国家汉语国际推广领导小组办公室
丰满	丰满区
奈恩郡	nairnshire
北大法学院	北京大学法学院
新华社	新华通讯社
兰州外语职院	兰州外语职业学院
龙子湖	龙子湖区
卡马特	凯马特	kmart
开封电大	开封广播电视大学
宝丰	宝丰县
濮阳	濮阳县	濮阳市
昌平	昌平区
雅尔塔	yalta
林业站	林业工作站
新华电脑学院	贵州市新华电脑学院
仲裁委	仲裁委会	仲裁委员会
爱沙尼亚	爱沙尼亚共和国
金闽商学院	福建金闽再造烟叶发展有限公司商学院
黄大	黄山大学
削面	刀削面
重庆天文科普教育协会	重庆市天文科普教育协会
原住民部落社区大学	台东县原住民部落社区大学
深圳残院	深圳电大残疾人教育学院
育空河	yukon
斯塔福德郡	staffordshire
富士康	foxconn	富士康科技集团
广东纺织职院	广东纺织职业技术学院	广东纺织职业学院
海南外语职院	海南外国语职业学院	海南外语职业学院
土左旗	土默特左	土默特左旗
河南政管干	河南省政法管理干部学院	河南政法管理干部学院
中大网络学院	中山大学网络教育学院
宜君	宜君县
西7门	西七门
广济中心小学	宁波市广济中心小学
东方职院	东方职业技术学院	廊坊东方职业技术学院	廊坊东方职业学院	东方职业学院	长春东方职业学院
米耶雷斯	mieres
中国农大国际学院	中国农业大学国际学院
康威	kangwei
山东电专	山东电力高等专科学校	山东电力专科学校
宾得	pentax
汉沽	汉沽区
莱茵河	rhine
渭城	渭城区
科技学院	肇庆科技技术学院
空大	空中大学
新疆轻工职院	新疆轻工职业技术学院	新疆轻工职业学院
江职医大	江苏职工医科大学	江职医科大
龙华	龙华区
诗丽堂	诗丽堂美容美体国际连锁机构
靖州	靖州苗族侗族自治县	靖州县	靖州自治县
龙文	龙文区
星巴克	starbucks
江西科技师范	江西科技师范学院
李维斯	levi's	levis
佛山电大	佛山广播电视大学
鲁大	鲁汶天主教大学	鲁东大学
大同大学	山西大同大学
瑞安实验小学	浙江省瑞安市实验小学
仁化	仁化县
青工委	青年工作委员会	青工委会
湟中	湟中县
阿瓦提	阿瓦提县
分众传媒(中国)控股有限公司	focusmediaholdinglimited
优之星	u-star	ustar
旁氏	ponds
积姬仙奴	gatineau
永福	永福县
迈达康	迈达康全球连锁
房资所	房屋土地管理所	房屋管理所	房屋土地资源管理所	房地资源所	房地资源管理所	房地所
申洋学院	上海申洋国际交流进修学院
永安机场	东营机场	东营永安机场
乍得	乍得共和国
马弗京	mafeking
伊斯其兰岛	ischia
藏民院	西藏民族学院	西藏民院
北京美语学院	北京美国英语学院	北京美国语言学院	北京美国英语语言学院
北大资流学院	北大资流研修学院	北京大学资流研修学院
北大药学院	北京大学药学院
延安	延安市
长工	长春工业大学	长春工大	长工大
江西现代职院	江西现代职业学院	江西现代职业技术学院
奥克尼群岛	orkney
忻州师范	忻州师范学院	忻州师院
万里学院	浙江万里学院
外办	政府外事办	人民政府外事办	外事办公室	人民政府外事办公室	外事办
锼高中	江苏省锼高级中学
房市	楼市
金立	gionee
吴堡	吴堡县
油尖旺	油尖旺^
茶陵	茶陵县
麦德龙	麦德龙集团	metro
尤尼克斯	yonex
法医院	法医医院
尼勒克	尼勒克县
容城	容城县
广东职院	广东职业技术学院	广东职业学院
济宁东方艺术学校	山东省济宁市东方艺术学校
古浪	古浪县
上海震旦职院	上海震旦职业学院
拉巴特	rabat
长垣	长垣县
赤道几内亚	赤道几内亚共和国
八步	八步区
承德石油专科学校	承德石油高等专科学校
涡阳	涡阳县
长院	长沙学院
工商联	工商界联合会
科尔曼	coleman
沈指	中国人民武装警察部队沈阳指挥学院	沈指学院	武警沈阳指挥学院
竹溪	竹溪县
湖体职院	湖南体育职业学院
河北地职大	河北地质职工大学	地质职工大学
武指森林部队分院	中国人民武装警察部队指挥学院森林部队分院	武警指挥学院森林部队分院
卡托维兹	katowice
冶专物流学院	昆明冶金高等专科学校物流学院
诚一锅	老诚一锅	城一锅	老城一锅
巨鹿	巨鹿县
石老人机场	石老人直升机场
正定	正定县
天一职院	宁波天一职业学院	宁波天一职院	宁波天一职业技术学院
内蒙古电力学院	内蒙古工业大学电力学院
本溪一中	本溪市第一中学
蚌山	蚌山区
珠海城市职院	珠海城市职业学院	珠海城市职业技术学院
东方理工	东方理工学院
7区	七区
海信	hisense
艺晶	artview
林业局	国家林业局	林管局
海兴	海兴县
水美媒	oguma水美媒
兰西	兰西县
检疫局	防疫检疫局
园林处	园林绿化管理处	园林绿化处	园林管理处
山大威海分校	山东大学威海分校
快递	速递
驾校	驾驶学校	驾驶员培训学校	驾驶学院	驾院	汽车驾驶员培训学校	汽车驾驶学校	机动车驾驶员培训学校	学车	机动车驾驶学校
寒港学院	青岛寒港科技专修学院
华点	华点软件学院
商院	国商学院	国商院	商业职业学院	国商职院	国际商务职院	商业职业技术学院	商职院	商学院	商务职院	商业职院	商务学院	国际商务学院	国商职业学院	国际商务职业学院
渤海银行	chinabohaibank	cbhb	渤海银行股份有限公司
湖北师院文理学院	湖北师范学院文理学院
经贸外语学院	内蒙古经贸外语职业学院
绥中	绥中县
东站	东客站	东客运站	客运站东站	客运东站
沈阳卫生所	沈阳卫生监督所
偏关	偏关县
侯马	侯马市
葆贞女院	葆贞女子国民学院
西电软件学院	西安电子科技大学软件学院
山西财职院	山西财贸职业学院	山西财贸学院
崇信	崇信县
真功夫	真功夫餐厅	真功夫原盅蒸饭
圣弗朗西斯科河	saofranciso	saopaulo
东硬学院	南海东硬信息技术学院
深圳	深圳市
安徽现代信息工程职院	安徽现代信息工程职业学院
途韵	bestwe
陕西邮电职院	陕西邮电职业技术学院	陕西邮电职业学院
金陵学院	南大金陵学院	南京大学金陵学院
无锡职大	无锡市职工大学
金坛三中	金坛市第三中学
侨大	华侨大学	燕京华侨大学
金山职院	金山职业技术学院	金山职业学院
云艺	云南艺术学院
中德心理	中德心理大学
特步	xtep
潮安	潮安县
道奇	dodge
库尔斯克	kursk
中韩学院	中韩协作国际互市学院
贝罗	balo
复兴	复兴区
广东考试院	广东教育考试学院
闸北	闸北区
金士刚	kingxcon
永新	永新县
中国铝业公司	chalco
希捷	seagatetechnology	seagate
3院	三医院	第三医院	三院	第三人民医院	第3医院	第3人民医院	3医院
冲绳岛	okinawa
家居装	家居服
西安电专	西安电力专科学校	西安电力高等专科学校
发改委	发展和改革委员会	国家发展和改革委员会	中华人民共和国国家发展和改革委员会	发改委会	国家发改委
首大兴科	北京首大兴科技术研究院
宾利	bentley
临沭	临沭县
宁波城市职院	宁波城市职业技术学院	宁波城市职业学院
驰为	chuwi
永亨银行	香港永亨银行	winghangbank
南邮	南京邮大	南京邮电大学	南邮大学
江西机电职院	江西机电职业技术学院	江西机电职业学院
河南工贸学院	河南工业贸易学院	河南工业贸易职业学院	河南工贸职院
庐阳	庐阳区
五寨	五寨县
河海大文天学院	河海大学文天学院
海滨学院	北京交通大学海滨学院	交大海滨学院
墨西哥	墨西哥合众国	mexico
塔尔沙漠	thardester
昆明机场	昆明长水机场	昆明巫家坝国际机场	昆明旧机场	昆明新机场	昆明国际机场	巫家坝机场	长水国际机场	长水机场	昆明巫家坝机场	昆明长水国际机场
霍山	霍山县
上思	上思县
安电大广德学院	安徽广播电视大学广德学院
英山	英山县
钟楼	钟楼区
核科院	核科学院	核科学学院
东门	东大门	东门口
资兴	资兴市
湖大	湖南大学	湖北大学
华锐学院	信阳师范华锐学院
川大成教院	四川大学成人教育学院	四川大学成教院	川大成人教育学院
天津外经贸学院	天津对外经济贸易职业学院	天津对外经济贸易学院
搜狗	sogou
阿拉善	阿拉善市	阿拉善盟
吉林司法警官高等职院	吉林司法警官高等职业学院
安徽中澳科技职院	安徽中澳科技职业学院
新乐	新乐市
川外	四川外语学院
尼索	neso
桂理	桂林理工大	桂林理工大学	桂林理工	桂理大
塘院	塘田战时讲学院
五通桥	五通桥区
博逸轩	博逸轩艺术创意研究院
亚琛工大	亚琛工业大学
葛洲坝职工大学	葛洲坝水电职工大学
三峡学院	湖北三峡学院
都匀	都匀市
Heard	赫德岛和麦克唐纳岛
镇宁	镇宁县	镇宁布依族苗族自治县	镇宁自治县
药监局	食品监督管理局	药品监管局	食品监管局	食品药品监督管理局	食品药品监管局	国家药监局	药品监督管理局	国家食品药品监督管理局
诺丁汉大学	宁波诺丁汉大学	宁波诺丁汉
武胜	武胜县
米尼卡	minica
吉农大	吉林农业大学	吉林农大
南大培训学院	广东南大职业培训学院
主副食品	主副食食品
孚日山脉	vosges
国泰学院	上海国泰外国语进修学院
厚生幼儿园	宁波厚生幼儿园
江西青年职院	江西青年职业学院
明光	明光市
哈体院	哈尔滨体院	哈尔滨体育学院
环亚学校	昆明环亚职业美容美发培训学校	环兴达环亚职业培训学校	昆明环亚职业培训学校
平坝	平坝县
鳄鱼	crocod
西里西亚	silesia
cnr	中国北车股份有限公司
钢城	钢城区
怀化	怀化市
清城	清城区
徐州工业职院	徐州工业职业学院	徐州工业职业技术学院
塞尔扣克郡	selkirkshire
cnc	长城电器
金华市科协	金华市科学技术协会
广州城市职院	广州城市职业学院
平安	平安县
服装市场	服装批发市场
审计署	中华人民共和国审计署	中国审计署	国家审计署
顺义	顺义区
中国化工集团公司	chemchina
黑龙江林业职院	黑龙江林业职业技术学院	黑龙江林业职业学院
政府	省省人民政府	盟盟人民政府	乡乡政府	乡政府	区区人民政府	旗政府	区区政府	区人民政府	省政府	盟政府	县县政府	县政府	旗人民政府	市市政府	市市人民政府	旗旗政府	地区人民政府	镇镇政府	地区政府	州政府	人民政府	州人民政府	镇镇人民政府	区政府	县人民政府	乡乡人民政府	州州人民政府	盟盟政府	旗旗人民政府	省人民政府	镇人民政府	镇政府	州州政府	县县人民政府	盟人民政府	省省政府	市人民政府	乡人民政府	市政府
广西建设职院	广西建设职业学院	广西建设职业技术学院
常州一中	常州市第一中学
卫辉	卫辉市
惠民	惠民县
同创学院	青岛同创科技专修学院
北师大出版社	北京师大出版社	北京师范大学出版社
贵阳职院	贵阳职业技术学院	贵阳职业学院
美孚	exxonmobil
鑫记	福鑫记
e龙	艺龙旅行网	elong
瑞煜	realtek
沪剧院	沪剧剧院
外语	外国语
江西前锋软件职院	江西前锋软件职业学院	江西前锋软件职业技术学院
兴义民族师范	兴义民族师范学院	兴义民族师院
广宁电大	广宁县广播电视大学
西区	西校区	西院区	西院
四川法警职院	四川法警职业学院	四川司法警官职业学院
人事部	中华人民共和国人事部	国家人事部	中国人事部
西青	西青区
劳动大学	中国劳动者共产主义大学
灵山	灵山县
企业	单位
婕妮路	婕妮璐
湖南民族职院	湖南民族职业学院
漳州吉马印刷职院	漳州吉马印刷职业学院	漳州吉马印刷职业技术学院
预警报	预警警报
云南机电职院	云南机电职业学院	云南机电职业技术学院
文体	文化体育
兴湘学院	湘潭大学兴湘学院
社大	社区大学
青软培训	青软培训学院
萨尔茨堡	salzburg
大汽职院	大连汽车职院	大连汽车职业学院	大连汽车职业技术学院
火车	列车
重庆机电职院	重庆机电职业技术学院	重庆机电职业学院
重大网院	重大网络学院	重大网络教育学院	重庆大学网络教育学院
朔源学院	朔源心理成长学院
鹤山职业技术中学	鹤山市职业技术高级中学
天津	天津市
遂平	遂平县
多伦	多伦县
猫王	elvispresley
德宏职院	德宏职业学院
安徽电气工程职院	安徽电气工程职业学院	安徽电气工程职业技术学院
杨虎城学院	陕西杨虎城进修学院
无线永伴	sonbuddy
尼吉康	nichicon
龙泉驿	龙泉驿区
山东水利职院	山东水利职业学院
宜家	宜家家居	宜家中国	中国宜家	ikea
斯德哥尔摩	stockholm
山东法警职院	山东法警职业学院	山东司法警官职业学院
三星	sumsung
东南7门	东南七门
社会学院	社会学学院
敖汉	敖汉旗
远教院	远程教育学院
尖山	尖山区
厦门理工	厦门理工学院
泉州电大	泉州电视大学
杭州工大	杭州工人业余大学
川经院	四川南充经济专修学院
东山机场	海拉尔机场	呼伦贝尔机场	海拉尔东山机场	呼伦贝尔东山国际机场	东山国际机场	呼伦贝尔国际机场
洛基山脉	rockymountains
链家	链家地产
郧阳师专	郧阳师范专科学校	郧阳师范高等专科学校
青大	青海大学	青岛大学
台北帝大	台北帝国大学
思澄堂	基督教会思澄堂
习水	习水县
海城	海城区	海城市
川大外语学院	川大外国语学院	四川大学外语学院	四川大学外国语学院
山建大	山东建筑大学
北京长城学院	北京长城研修学院
研究所	研究室	研究院
海畅	hacha
莲都	莲都区
勃利	勃利县
建阳	建阳市
商丘师院	商丘师范	商丘师范学院
抚远	抚远县
梨树	梨树县	梨树区
安农大	安徽农业大学	安徽农大
武汉纺大学外经贸学院	武汉纺织大学外经贸学院
北京经管院	北京经济管理职业学院	北京经济管理学院
安顺	安顺市
纳尔维克	narvik
台北海院	台北海洋技术学院
川教院	四川教育学院
31冰淇淋	31种美国风味冰淇淋
工商所	工商管理所	工商行政管理所
丰泽	丰泽区
金门	金门县
联发科	mediatek
文传院	文化传播学院
糖水	正宗化州糖水	化州糖水	糖水美食亭
浣纱小学	浙江诸暨市浣纱小学
天津国土资源和房屋职院	天津国土资源和房屋职业学院
虹桥第八小学	乐清市虹桥镇第八小学
蚌医	蚌埠医学院
延庆	延庆县
美拉尼西亚	melanesia
东财网院	东北财经大学网络教育学院
密执安	michigan
上海人小孩儿学院	上海人小孩儿继续教育进修学院
湖南机电职院	湖南机电职业技术学院	湖南机电职业学院
仲巴	仲巴县
茂名	茂名市
豪威	omnivision
青江大学	青江文化产业大学
金明	金明区
天津农大	天津农业大学
问漳州电大	问漳州电视大学
新疆医大	新疆医科大学	新疆医科大
乌兰	乌兰县
台职院	台州职业学院	台州职业技术学院
凯波学院	大西洋凯波社区学院
勒拿河	lena
金华职院	金华职业技术学院	金华职业学院
长医	长沙医学院
储备	贮备
辽宁石化大学顺华能源学院	辽宁石油化工大学顺华能源学院
林西	林西县
江西新闻出版职院	江西新闻出版职业学院	江西新闻出版职业技术学院
环保局	环境保护局	环境保护管理局
世纪前线	avl世纪前线
安徽新华电脑学院	安徽新华电脑专修学院
粤剧	广东戏
哈尔滨应用职院	哈尔滨应用职业学院	哈尔滨应用职业技术学院
哈尔滨电大	哈尔滨广播电视大学
浙院	浙江学院	上海财经大学浙江学院	上海财大浙江学院	上财浙院
正镶白	正镶白旗
新疆交通职院	新疆交通职业技术学院	新疆交通职业学院
黄石港	黄石港区
仁怀	仁怀市
奎屯市电大	奎屯市广播电视大学
云霄	云霄县
福泉	福泉市
cofco	中粮集团有限公司
悦丝	yesi
东南5门	东南五门
耀州	耀州区
达孜	达孜县
新世纪学院	上海新世纪信息进修学院
德宏机场	德宏芒市机场	芒市机场
雅加达	jakarta
盘龙	盘龙区
安顺职院	安顺职业技术学院	安顺职业学院
职专	职业中专
浙师大行知学院	浙江师范大学行知学院
佰	百
农业科技学院	农业科技技术学院	农业技术科技学院
高陵	高陵县
依客隆	依客隆门业
兰州理工大技术工程学院	兰州理工大学技术工程学院
长乐	长乐市
美能达	minolta
云溪	云溪区
江西护理职院	江西护理职业技术学院	江西护理职业学院
慕斯蛋糕	幕斯蛋糕
重庆传媒职院	重庆传媒职业学院
如家	如家酒店	如家快捷连锁酒店	如家快捷酒店	如家连锁酒店	如家快捷	如家连锁快捷酒店	如家连锁
蓝天使	blueangel
睿信龙	北京睿信龙电子技术研究所
榆树	榆树市
装潢	装修	装饰	装璜
全季酒店	汉庭全季酒店	汉庭全季
爱卡	爱卡汽车	爱卡汽车俱乐部
沪大	沪江大学
郑州牧专	郑州牧业工程高等专科学校	郑州牧业工程专科学校	郑州牧工专科学校
武汉航海职院	武汉航海职业技术学院	武汉航海职业学院
合川	合川区
颍泉	颍泉区
依梦达	imada
卢湾	卢湾区
镇康	镇康县
铲车	铲运车
东6门	东六门
云南农科院	云南省农业科学院
刑警学院	中国刑事警察学院
江苏电大	江苏广播电视大学
崇光	香港崇光	香港崇光百货
沐川	沐川县
皇姑	皇姑区
红河	红河县	红河州	红河市	红河哈尼族彝族自治州	红河自治州
标准化研究院	中国标准化研究院
荷塘	荷塘区
青白江	青白江区
安大略	ontario
滨海东方机场	天津滨海东方机场
初教院	初等教育学院	初教学院
道里	道里区
施乐	xerox	富士施乐
3中	第3中学	第三中学	三中
资溪	资溪县
萨福克	suffolk
莱索特贴膜	莱索特爵士贴膜
天津城市职院	天津城市职业学院
江西电力职院	江西电力职业学院	江西电力职业技术学院
东方美食	东方美食学院
泰和	泰和县
扬大广陵学院	扬州大学广陵学院
邢台职院	邢台职业学院	邢台职业技术学院
远东轮船	fesco	北京外企服务集团有限责任公司
茌平	茌平县
元氏	元氏县
云科大	云林科技大学	云林科大
荟华楼	荟华楼金店
策勒	策勒县
桑德兰	sunderland
富拉尔基	富拉尔基区
迈阿密	miami
同济同科学院	同济大学同科学院
伊利诺伊	illinois
哈根达斯	haagendazs	haagen-dazs
横山	横山县
大厂	大厂回族自治县	大厂县	大厂自治县
威海外语进修学院	山东威海外国语进修学院
幼江农科院	武汉幼江源域农林科学院
沈化大	沈阳化工大学
嘉峪关	嘉峪关市
木垒	木垒县	木垒哈萨克自治县	木垒自治县
渭滨	渭滨区
凯恒天德	凯恒天德管理学院
东莞	东莞市
徐海学院	中国矿大徐海学院	矿大徐海学院	中国矿业大学徐海学院	矿业大学徐海学院
1	壹	no1	第一	Ⅰ	一	第1
台神	台湾神学院
藏职院	西藏职业技术学院	西藏职业学院
湟源	湟源县
绍成	宁波市北仑区绍成小学
滁州职院	滁州职业学院	滁州职业技术学院
乌职大	乌鲁木齐职业大学
靖远	靖远县
乃东	乃东县
龙潭	龙潭区
岐山	岐山县
湖南涉外学院	湖南涉外经济学院
多米尼克	多米尼克联邦
汕头市职院	汕头市职业技术学院	汕头市职业学院
摩加迪沙	mogadishu
英伦培训学院	英伦国际健身教练培训学院
广西工业职院	广西工业职业技术学院	广西工业职业学院
冀职院	冀中职业学院	冀中职院
里九外七	里九外七茶社
西萨摩亚	westernsamoa	西萨摩亚独立国
乳源	乳源县	乳源自治县	乳源瑶族自治县
郑州信息科技职院	郑州信息科技职业学院
旺庄实验小学	无锡市新区旺庄实验小学
电大学院	义乌市电大学院
工信部	工业和信息化部	中国工信部	中华人民共和国工业和信息化部	中华人民共和国工信部	中国工业和信息化部
冈比亚Gambia	冈比亚共和国
木里	木里藏族自治县	木里县	木里自治县
四川艺术职院	四川艺术职业学院
四川警安职院	四川警安职业学院
井大	井冈山大学
拉普兰	lapland
台山	台山市
德保	德保县
圣伊萨贝尔	santaisabel
屏边	屏边县	屏边苗族自治县	屏边自治县
平昌	平昌县
三水	三水区
斯维尔德洛夫斯克	sverdlosk
洪雅	洪雅县
贵州职院	贵州职业技术学院	贵州职业学院
轮台	轮台县
杭州机场	萧山机场	杭州国际机场	杭州萧山国际机场	萧山国际机场
北普拉特河	northplatte
天桥	天桥区
安徽医大	安徽医科大学	安徽医科大
封丘金银花研究所	河南封丘农科中心金银花研究所
4区	四区
华冶设备研究所	太原华冶设备研究所
马关	马关县
久治	久治县
几内亚	几内亚共和国
九城	九城^
三穗	三穗县
圣多明各	santodomingo
朝天	朝天区
东南4门	东南四门
丽江旅院	丽江旅游文化学院
中青旅	中国青年旅行社
苏州星海学校	苏州工业园区星海学校
齐陶大学	齐陶应用科学大学
枣强	枣强县
钢铁集团公司职工大学	鞍山钢铁集团公司职工大学
眉山职院	眉山职业技术学院	眉山职业学院
内戈尤尔峰	negoiul
河南机电专科学校	河南机电高等专科学校
亚心景观规划院	新疆亚心景观规划设计院
广州宜家	宜家广州	广州宜家家居
军装	军服
蒙古	蒙古国	mongolia
吉林农科院	吉林农业科技学院
三义机场	丽江三义机场	丽江机场
墨玉	墨玉县
华东政法	华东政法大学
虎丘	虎丘区
广水	广水市
石家庄外经贸	石家庄外经贸职业学院	石家庄外经贸学院
吴兴	吴兴区
淮上	淮上区
劳力士	rolex
崇州	崇州市
中山三鑫双语学校	中山纪念中学三鑫双语学校
商州	商州区
七彩玫瑰	七色玫瑰
中环管院	中国环境管理干部学院	中国环管干
慈大	慈济大学
那坡	那坡县
数科院	数学科学院	数学科学学院
毕节职院	毕节职业技术学院	毕节职业学院
佛得角	佛得角共和国
厦门国际银行	xiameninternationalbank
小钢花舞蹈	邯郸市小钢花舞蹈艺术学校
基威廷	keewatin
苏职大	苏州市职业大学
江南影视艺职	江南影视艺术职院	江南影视艺术职业学院
地矿局	地质矿产勘查开发局
饶平中心幼儿园	饶平县中心幼儿园
天津商学院宝德学院	天津商业大学宝德学院
冈商大	冈山商科大学
长宁科技	上海市长宁科技进修学院
瑙鲁	nauru	瑙鲁共和国
武指武汉分院	中国人民武装警察部队指挥学院武汉分院	武警指挥学院武汉分院
人行	中国人行	thepeople'sbankofchina	中央银行	人民银行	pbc	央行	中国人民银行
北仑	北仑区
南通纺院	南通纺织技术学院
百利通	pericom
广东松山职院	广东松山职业技术学院	广东松山职业学院
北农院	北京农学院
济南电大	济南广播电视大学
麦田房产	麦田地产
里约热内卢	riodejaneiro
湖工	湖工院	湖南工程学院	湖南工学院
九江县一中	九江县第一中学	江西省九江县第一中学
南关	南关区
吉大商学院	吉林大学商学院
铁青国旅	广东铁青国际旅行社	广东铁青国旅	广东铁青
广大松田学院	广州大学松田学院
呼市	呼和浩特	呼和浩特市
撒丁	sardinia
广西经贸职院	广西经贸职业学院
抚州	抚州市
赛维克	sawink
华科	科技大学	中华科大	华科大	北科	华中科技大	北科大	华中科技	北京科技大	北京科技大学	中华科技大学	中国科学技术大学	华中科技大学	科大	华中科大	科技大	中国科技大学	中科大	北京科大	中国科大
四川科技职院	四川科技职业学院
联想	lenove	lenovo	联想集团
广东国土测绘院	广东省国土资源厅测绘院
肯尼亚	肯尼亚共和国	kenya
栾川	栾川县
南艺	南京艺术学院
热科院	中国热带农业科学院
遵医口腔学院	遵义医学院口腔学院
薇可	vivicam
美丽会	美丽汇
蓝莲花	兰莲花
客服	客户服务
镇雄	镇雄县
普洱机场	思茅机场	普洱思茅机场
路易斯安那	louisiana
兰蔻	lancome
中西	中西^
诏安	诏安县
即墨	即墨市
神舟	hasee
洞口	洞口县
露得清	neutrogena
中卫	中卫市
绍兴托普信息职院	绍兴托普信息职业学院	绍兴托普信息职业技术学院
五常	五常市
威尔特郡	wiltshire
南宫	南宫市
正宁	正宁县
五三研究所	中国兵器工业集团第五三研究所
共青团	中国共产主义青年团
招行	中国招行	中国招商银行	chinamerchantsbank	cmb	招商银行	招商银行股份有限公司
交管局	北京市交管局	北京交管局	北京市公安局公安交通管理局	北京交通管理局	北京市交通管理局	交通管理局
藏大	西藏大学
蒙斯特	munster
泰晤士河	thames
统战部	统一战线工作部
外包职院	外包职业学院
溪落渡	溪洛渡
山西警官职院	山西警官职业学院
中央电大	中央电视广播大学
秦皇岛电大	秦皇岛广播电视大学
库页岛	sakhalin
休宁	休宁县
重庆工程职院	重庆工程职业技术学院	重庆工程职业学院
山西电力职院	山西电力职业学院	山西电力职业技术学院
潮南	潮南区
苏州工业职院	苏州工业职业学院	苏州工业职业技术学院
泸州电大	泸州广播电视大学
江大文理学院	江汉大学文理学院
北京保险学会	北京保险行业协会
铜仁	铜仁市	铜仁地区
肖尼	shawnee
辽医医疗学院	辽宁医学院医疗学院
爱克发	agfa
莫泰	莫泰168连锁	莫泰连锁	莫泰酒店	motel	莫泰旅店	莫泰168酒店	莫泰连锁酒店	莫泰168	motel168	莫泰168连锁酒店	莫泰连锁旅店
拉韦纳	ravenna
益阳医专	益阳医学专科学校	益阳医学高等专科学校
文汇幼师	文汇幼儿师范培训学院
开鲁	开鲁县
佛山一中	广东省佛山市第一中学
成都大学继续教育	成都大学继续教育学院
太大	太原大学
凯文警视技术研究所	北京市凯文警视技术研究所
富彩	forsa
里奥格兰德河	riogrande
奥尔德姆	oldham
湛河	湛河区
福建革大	福建人民革命大学
列宁格勒	leningard
广西电大	广西广播电视大学
重庆海联职院	重庆海联职业技术学院	重庆海联职业学院
产院	妇产科
乐山职院	乐山职业技术学院	乐山职业学院
内财	内蒙古财经学院	内蒙古财经	内财院	内蒙古财经院
北美职院	云南北美职业学院	北美职业学院
新奥学院	新奥工程技术学院
日照电大	日照广播电视大学
梧州职院	梧州职业学院
山西省戏剧职院	山西省戏剧职业学院
托基	torquay
摩可兜勒	摩诃兜勒
化工职大	重庆化工职工大学
马盖先	magforce
铝材	铝型材
深大	深圳大学
南京旅职	南京旅游职业学院	南京旅游职院
广东机电职院	广东机电职业学院	广东机电职业技术学院
高明	高明区
创业培训学院	顺德创业培训学院
城西	城西区
天津美院	天津美术学院
报亭	报刊亭
肇庆电大	肇庆广播电视大学
长沙城南学院	长沙理工大学城南学院
平阳	平阳县
南澳大利亚	southauwtralia
罗利	raleigh
高密	高密市
花岗岩石	花岗岩岩石
清华紫光	unis	清华紫光股份有限公司
重庆	重庆市
吉林铁道职院	吉林铁道职业学院	吉林铁道职业技术学院
重师商院	重庆师范大学涉外商贸学院
桐乡少文院	桐乡市少年文学院
遂宁	遂宁市
地大	地质大学	中国地质大学	中国地大
渝北	渝北区
恭和堂	恭和堂龟苓膏
西安高新科技职院	西安高新科技职业学院
船营	船营区
多乐士	dulux
赛格人才	深圳赛格人才培训中心
方正	方正县	founder
广州涉外经济职院	广州涉外经济职业技术学院	广州涉外经济职业学院
佛教会	佛教教会
杭师大	杭州师范学院	杭州师范大学	杭州师范	杭州师大	杭州师院
柏科	boke
江西管理职院	江西管理职业学院
安徽师大皖江学院	安徽师范大学皖江学院
靖边	靖边县
宁晋	宁晋县
襄城	襄城县	襄城区
高淳	高淳县
联通	中国联通
威望迪	vivendi
精通学院	天津精通职业技术专修学院
巴里坤	巴里坤哈萨克自治县	巴里坤自治县	巴里坤县
西农	西北农科大	西北农林科大	农林科技大学	西北农林科技大学	农林科技大	农科大	农林科大
安徽医专	安徽医学高等专科学校
灵丘	灵丘县
多丽	doll
宁江	宁江区
淅川	淅川县
谢家集	谢家集区
海滨	海滩
交运工学院	交通运输工程学院
斯图尔特岛	stewartisland
柏氏	pat's	pats
宜昌一中	湖北省宜昌市第一中学
鞍山	鞍山市
齐鲁师范	齐鲁师范学院	齐鲁师院
警大	警察大学
威尔明顿	wilmington
上海中华职院	上海中华职业技术学院	上海中华职业学院
受贿	纳贿
大溶洞机场	北京大溶洞机场
花都	花都区
新兴职院	新兴职业学院
渝中	渝中区
山西师大临汾学院	山西师范大学临汾学院
大洼	大洼县
澄海	澄海区
马山	马山县
前进学院	前进进修学院
白俄罗斯	白俄罗斯共和国
东营	东营市	东营区
苏科院	苏州科技学院
必胜客	必胜客欢乐餐厅	pizzahut
索马里	somalirepublic	索马里共和国	somalia
安徽财职院	安徽财贸学院	安徽财贸职业学院
周口职院	周口职业学院	周口职业技术学院
南阳里小学	广州市番禺区市桥南阳里小学
东油	东北油大	东北石油大学	东油大学
安徽	安徽省
三亚航空旅游职院	三亚航空旅游职业学院
北京农科院	北京农林科学院
龙口	龙口市
国商	国际商学院	北外国商	北京外国语大学国际商学院	北外国际商学院
元宝山	元宝山区
大同	大同县	大同市	大同区
山东大王职院	山东大王职业学院
大通	大通区	大通县	大通回族土族自治县	大通自治县
绿委办	绿化委员会办公室	绿化委办公室
大田一中	福建省大田第一中学
普格	普格县
赛思外语	青岛赛思外语学校
四川电力职院	四川电力职业技术学院	四川电力职业学院
旅店	招待所	住宿	客栈	旅社	旅舍	旅馆
贵阳一中	贵阳市第一中学
摩纳哥	摩纳哥公国	monaco
延川	延川县
普陀	普陀区
海莱学院	重庆师范大学海莱学院
金湾	金湾区
辽宁信息职院	辽宁信息职业学院	辽宁信息职业技术学院
嘉禾	嘉禾县
曲江	曲江区
长兴	长兴县
当涂	当涂县
三得利	suntory
延大	延世大学	延安大学	延边大学
河北劳动关系职院	河北劳动关系职业学院
兴大	中兴大学
开平电大	开平市广播电视大学
托雷斯海峡	torresstrait
汽贸	汽车贸易
钟楼区科技实验幼儿园	常州市钟楼区科技实验幼儿园
电机学院	上海电机学院
岗巴	岗巴县
东湖豪苑	东湖豪庭
蝶山	蝶山区
佛坪	佛坪县
United	States
国家遥感中心	中华人民共和国科学技术部国家遥感中心
喀喇沁左翼	喀喇沁左翼蒙古族自治县	喀喇沁左翼自治县	喀喇沁左翼县
美属太平洋各群岛(包括:中途岛、
泊头电大	泊头广播电视大学
桐庐	桐庐县
临夏	临夏县	临夏州	临夏市	临夏自治州	临夏回族自治州
台州电大	台州广播电视大学
乌海职院	乌海职业学院	乌海职业技术学院
西工大航天学院	西北工业大学航天学院
卢森堡	卢森堡大公国	luxemburg	luxembourg
中国雅虎	中国yahoo	yahoo	yahoo中国
中华建珠海设计院	北京中华建规划设计研究院珠海分院
欧卡	oka	奥卡河
中传大	中国传媒大学	传媒大学	中国传大
浙江建设职院	浙江建设职业学院	浙江建设职业技术学院
南沙	南沙区
南山	南山区
侯爵	marquis
马克西玛	maxima
南商	南洋商业银行	nanyangcommercialbank	南洋银行	南商(中国)	南商中国	南洋商业银行(中国)有限公司	ncb	中国南洋商业银行
囊谦	囊谦县
新财商务学院	新疆财经大学商务学院
尉犁	尉犁县
三井	mitsui
安费诺	amphenol
廷布	thimph
山西省水利局	山西省水利建筑工程局
紫阳	紫阳县
爱民	爱民区
湖南中医专	湖南中医药高等专科学校	湖南中医药专科学校
莫比尔	mobile
昆士兰	queensland
马鞍山师专	马鞍山师范专科学校	马鞍山师范高等专科学校
南神	台南神学院
瓜州	瓜州县
碧斯	bestcare
辉县	辉县市
普尔兰德	pureland
江大外语学院	江南大学外国语学院	江大外国语学院
大宇学院	大宇职业技术学院
冀联医学院	石家庄冀联医学院
郎溪	郎溪县
新安怡	avent
荣成	荣成市
山东青管干	山东青管干学院	山东省青年管理干部学院
红岗	红岗区
阳澄湖大闸蟹	阳澄湖清水大闸蟹
拉塔基亚	latakia
社区学院	建邺社区发展学院
兰州明达理工职院	兰州明达理工职业学院
华北联大冀唐学院	华北联合大学冀唐学院
永吉	永吉县
中国科技馆	中国科学技术馆新馆	中国科技馆新馆	中国科学技术馆
沃歌斯	wagas
裕民	裕民县
斯塔福德	stafford
酒厂	葡萄酒厂	葡萄酒酒厂
蛋糕	糕饼	糕点
兴文	兴文县
丰城	丰城市
友好	友好区
永济	永济市
南京经院	南京经济学院
邯郸	邯郸市	邯郸县
怀化医专	怀化医学专科学校	怀化医学高等专科学校
巴中电大	巴中广播电视大学
永嘉	永嘉县
革大	人民革命大学
石家庄科技职院	石家庄科技职业学院
百达翡丽	patek
财政部	中国财政部	中华人民共和国财政部	国家财政部
路虎	览胜陆虎	landrover
内师大	内蒙古师范	内蒙古师大	内蒙古师范大学
十堰教院	十堰教育学院
山东经院	山东经济学院
康定	康定县
兰州资源环境职院	兰州资源环境职业技术学院	兰州资源环境职业学院
保安营机场	攀枝花机场	攀枝花保安营机场
阿坝电大	阿坝广播电视大学
拉斯韦加斯	lasvegas
屯溪机场	黄山机场	黄山屯溪机场
希卡拉陶山	shkaratau
徽州	徽州区
南雄	南雄市
辽宁装备制造职院	辽宁装备制造职业学院	辽宁装备制造职业技术学院
高田贤三	kenzo
公安部	中国公安部	国家公安部	中华人民共和国公安部
富川	富川县	富川瑶族自治县	富川自治县
四川工商职院	四川工商职业学院	四川工商职业技术学院
黄岛街道办	青岛市黄岛区黄岛街道办事处
梅甘娜	megane
扎波罗	zaporozje
新泰	新泰市
闽剧院	闽剧剧院
国防大学	中国人民解放军国防大学
代理点	代办点
液晶	led
福建信息职院	福建信息职业学院	福建信息职业技术学院
平潭	平潭县
正泰	chint
城建职大	广州市城建职工大学
莱城	莱城区
大展机电研究所	南京大展机电技术研究所
抚顺师专	抚顺师范高等专科学校	抚顺师范专科学校
平塘	平塘县
1区	一区
佛莱明	fleming
云南锡业职院	云南锡业职业学院	云南锡业职业技术学院
建设部	国家建设部	中国建设部	中华人民共和国建设部
联合利华	unilever
金科院	金陵科技学院
罗阿诺克	roanoke
锦州师专	锦州师范专科学校	锦州师范高等专科学校	锦州师范高等专科学院	锦州师范专科学院
天吉泰机场	巴彦淖尔天吉泰机场	巴彦淖尔机场
后勤工程学院	中国人民解放军后勤工程学院	解放军后勤工程学院
新田	新田县
故宫	紫禁城
港大思陪学院	港大思陪科技职业学院
新港报关学院	青岛新港报关学院
进修学院	东方城市进修学院	深圳进修学院
鹰手营子	鹰手营子区	鹰手营子矿区
恰恰瓜子	洽洽瓜子
聂荣	聂荣县
卡拉哈里沙漠	kalahairdesert
吉林机场	吉林二台子机场	二台子机场
淮南联大	淮南联合大学
南广学院	中国传媒大学南广学院	中传大南广学院	中国传大南广学院	传媒大学南广学院
检疫站	防疫检疫站
三山	三山区
青川	青川县
清丰	清丰县
大新	大新县
黄州	黄州区
重庆航天职院	重庆航天职业技术学院	重庆航天职业学院
乌兹别克斯坦	乌兹别克斯坦共和国
管道学院	中国石油管道学院
海师大	海南师范	海南师范大学	海南师大
开达兴	hidaking
九三学社沙坪坝区委员会	九三学社重庆市沙坪坝区委员会
梅里斯	梅里斯达斡尔族区	梅里斯区
诚信服装学院	江西诚信服装专修学院
5	伍	第五	五	Ⅴ	no5	第5
河大民生学院	河南大学民生学院
西南7门	西南七门
天语	ktouch	k-touch
乐飞叶	lafuma
三藏佛学院	中国佛学三藏学院
赤城	赤城县
汤旺河	汤旺河区
姜堰	姜堰市
海昌中心幼儿园	海宁市海昌中心幼儿园
弥渡	弥渡县
郁南	郁南县
内蒙古建筑职院	内蒙古建筑职业学院	内蒙古建筑职业技术学院
二滩电站	二滩电厂
梁子湖	梁子湖区
马卡卢峰	makalu
真维斯	真维斯专卖店	jeanswest
蒙城	蒙城县	中国牛都
古琦	gucci	古驰	古奇
天津现代职院	天津现代职业技术学院	天津现代职业学院
集美大学诚毅	集美大学诚毅学院
天之骄子幼儿园	北京天之骄子智能开发幼儿园
上街	上街区
贵州警官职院	贵州警官职业学院
江农大	江西农业大学	江西农大
重庆外语学校	重庆外国语学校
渝水	渝水区
国服院	杭州国际服务工程学院
定安县
赤峰职院	赤峰职业技术学院	赤峰职业学院
重庆农科院	重庆市农业科学院
新大	新疆大学
泉州信息职院	泉州信息职业学院	泉州信息职业技术学院
武指杭州分院	武警指挥学院杭州分院	中国人民武装警察部队指挥学院杭州分院
祥云职业中学	祥云县职业高级中学
玉屏	玉屏自治县	玉屏县	玉屏侗族自治县
兰州职院	兰州职业学院	兰州职业技术学院
中美经贸学院	石家庄中美经贸学院
广东建设职院	广东建设职业技术学院	广东建设职业学院
城子河	城子河区
兰特拉	lantra
中国中钢集团公司	sinosteel
英德	英德市
成都机场	双流国际机场	成都双流国际机场	双流机场	成都国际机场
西盟	西盟县	西盟佤族自治县	西盟自治县
西门	西门口	西大门
威豹	weibao
浙江育英职院	浙江育英职业学院
魁北克	quebec
威宝	verbatim
漳州天福茶职院	漳州天福茶职业学院	漳州天福茶职业技术学院
盐城	盐城市
盐池	盐池县
志丹	志丹县
渭南职院	渭南职业学院	渭南职业技术学院
海口	海口市
庆丰祥	庆沣祥茶庄
首体院	首都体育学院
文莱	文莱达鲁萨兰国	brunei
易尚	yishang
宁化	宁化县
化妆品	化妆品店	护肤品
蓝旗亚	lancia	兰西亚
重庆生科大	重庆国际生命科技大学
措勤	措勤县
萍乡高专	萍乡高等专科学校
中法学院	中法时尚学院
小密苏里河	littlemissouri
青岛飞洋职院	青岛飞洋职业技术学院	青岛飞洋职业学院
民航管院	中国民航管理干部学院
武陵源	武陵源区
博冠	bosma
黄科院	黄河科技学院
雷射网讯	lecotek
保定	保定市
安徽菜馆	安徽土菜馆
新新人	新新人婚纱摄影
南京机电职院	南京机电职业学院	南京机电职业技术学院
周六	礼拜六	星期六
湖南工程职院	湖南工程职业学院	湖南工程职业技术学院
南汇	南汇区
北大经济学院	北京大学经济学院
大连航运职院	大连航运职业技术学院	大连航运职业学院
海都学院	莱阳农学院海都学院
繁昌	繁昌县
环卫站	环境卫生管理站
深圳资料职院	深圳资料职业技术学院	深圳资料职业学院
正大	中正大学
辽中	辽中县
苍南	苍南县
南岳	南岳区
湖南省电信工会	中国电信集团工会湖南省委员会
北京国标舞学院	北京国际标准舞学院
西安华夏技术培训	西安华夏技术培训学院
晋城电大	晋城广播电视大学
居委会	社区居民委员会	社区居委会	居民委员会
成都动物园	chengduzoo
南华	南华大学	南华县
凤山	凤山县
拜城	拜城县
业大	业余大学
安师大	安徽师范	安徽师范大学	安徽师大
深圳信息职院	深圳信息职业技术学院	深圳信息职业学院
建工学院	建筑工程学院	建筑学院	建筑工业学院
舞剧院	舞剧剧院
白云鄂博	白云矿区	白云鄂博矿区
毕加索	pegaso
重庆正大软件职院	重庆正大软件职业学院	重庆正大软件职业技术学院
江西大宇	江西大宇学院
原平	原平市
营山	营山县
上海科技出版社	上海科学技术出版社
瑜珈	yoga	瑜伽
城北	城北区
外贸职大	上海市对外贸易职工大学
农高院	农村高级种田学院
北京社科院	北京市社会科学院
江西冶金职院	江西冶金职业技术学院	江西冶金职业学院
晋中职院	晋中职业学院	晋中职业技术学院
北信科大	北京信科大	北京信息科技大学
正安	正安县
csgc	中国兵器装备集团公司
金溪	金溪县
维网	wealnet
吕底亚	lydia
川职院	四川职业技术学院	四川职业学院
鲁米娜	lumina
迎江	迎江区
昂仁	昂仁县
北碚	北碚区
宁武	宁武县
罗氏制药	rochegroup
福建科技出版社	福建科学技术出版社
阿玛尼	armani
muztaga	杭州慕士塔格户外用品有限公司
塔斯马尼亚	tasmania
华师汉口分校	华中师范大学汉口分校
1院	一院	第一医院	一医院	第1人民医院	第1医院	第一人民医院	1医院
别克	buick
屏科大	屏东科技大学	屏东科大
石楼	石楼县
阿图什	阿图什市
北5门	北五门
巴中	巴中市
巴州	巴州区
福特	fordmotor	ford
遵化	遵化市
奥斯莫比尔	ohdsmobile
渤海石油职院	渤海石油职业学院
南卡罗来纳	southcarolina
雷克沙	lexar
福田	福田区
河南法警职院	河南司法警官职业学院	河南法警职业学院
霍城	霍城县
甘肃交通职院	甘肃交通职业技术学院	甘肃交通职业学院
羊城学院	羊城科技专修学院
平舆	平舆县
同安	同安区
广东省外语艺术职院	广东省外语艺术职业学院
星火学院	山东星火职业培训技术学院
英皇学院	英皇表演艺术学院
肯德基	kfc
小笠原群岛	ogasawaraislands
阳信	阳信县
岳林街道办	中国奉化岳林街道办事处
华东模范中学	上海市华东模范中学
成都体院	成都体育学院
宇航局	航天局
南海东阮信息技术职院	南海东阮信息技术职业学院
瀚视奇	hannsg
玛多	玛多县
罗马	rome
毛里塔尼亚	mauritania	毛里求斯共和国
利默里克	limerick
伊犁职院	伊犁职业技术学院	伊犁职业学院
外国科大	外国科学技术大学
二野军大	第二野战军军事政治大学
华宁	华宁县
苏州技师	苏州技师学院
安徽电子信息职院	安徽电子信息职业学院	安徽电子信息职业技术学院
东南6门	东南六门
红桥	红桥区
弓长岭	弓长岭区
辽宁农业职院	辽宁农业职业技术学院	辽宁农业职业学院
东吴商学院	苏州大学东吴商学院	苏大东吴商学院
宁夏民族职院	宁夏民族职业学院	宁夏民族职业技术学院
帕萨特	passat
许府牛	许府老山东	许府牛老山东	许府牛老山东牛杂
苏州职大	苏州职业大学
台艺大	台湾艺术大学
九江医学院	江西九江医学院
沙县小吃	沙县营养小吃
娄底	娄底市
克罗格	kroger
领袖学院	香港国际领袖学院
浙江金融学院	浙江金融职业学院	浙江金融职院
市外贸业余大学	上海市对外贸易业余大学
华龙体院	河北华龙体育学院
泉州经贸职院	泉州经贸职业技术学院	泉州经贸职业学院
天元一品	天元一品装饰
施秉	施秉县
朔州机场	朔州安太堡机场	安太堡机场
兰州商院陇桥学院	兰州商学院陇桥学院
沈音	沈阳音乐学院
乌伊岭	乌伊岭区
武指福州分院	武警指挥学院福州分院	中国人民武装警察部队指挥学院福州分院
casic	中国航天科工集团公司
工贸技师学院	北京市工贸技师学院	北京工贸技师学院
莫纳克亚山	maunakea
龙里	龙里县
永昌	永昌县
嘉义社大	嘉义市社区大学
大连职工协会	大连市职工技术协会
下城	下城区
邮局	邮政局	邮政管理所	邮政支局	国家邮政局	邮电支局	邮政所	中国邮政	邮政管理局	邮电局	邮电所	邮政
双鸭山	双鸭山市
漠河机场	古莲机场	漠河古莲机场
大厦	大楼	楼宇
坡头	坡头区
国戏	中国戏曲学院
梅罗伊	meroe
省警院	河北省公安警察学院
中农大网院	中国农业大学网络教育学院
禄来	rollei
大显	daxian
厦艺	厦门演艺职业学院
无锡工艺职院	无锡工艺职业学院	无锡工艺职业技术学院
艾诺	ainol
兰交	兰州交大	兰交大	兰州交通大学
上地新世纪	北京上地新世纪生物医药研究所
大祥	大祥区
卫校	卫生学校
桃城	桃城区
图们	图们市
北大生科院	北大生命科学学院	北京大学生命科学学院
新北区实验	常州市新北区实验中学
信访局	国家信访局
荆门职大	荆门职业大学
爱普生	epson
长颈鹿	giraffe
上栗	上栗县
南大科技学院	南昌大学科学学院
声乐大学	彤云声乐大学
蓝山	蓝山县
江洲	江洲区
伊加尔卡	iharka
鹤岗师专	鹤岗师范高等专科学校	鹤岗师范专科学校
衡阳师范	衡阳师院	衡阳师范学院
上理	上理大	上海理工	上海理工大学	上海理工大
btmu	三菱东京日联银行	bankoftokyo-mitsubishiufj
东亭中心小学	无锡市东亭中心小学
惠大	惠州大学
龙江	龙江县
钟鼎	钟鼎古代艺术研究所
东阳	东阳市
菏泽家政职院	菏泽家政职业学院
金湖	金湖县
怒江	怒江傈僳族自治州	怒江自治州	怒江市	怒江州
飞利浦	philips
家美乐	camenae
分校	学区	校区
凌阳	sunplus
大邑	大邑县
卡拉奇	karachi
凤凰机场	铜仁凤凰机场	三亚机场	三亚国际机场	铜仁机场	凤凰国际机场	三亚凤凰国际机场
圣安娜	santaana
奥斯卡培训学院	广州市奥斯卡职业培训学院
官渡	官渡区
香奈儿	香奈尔	chanel
乌鲁木齐外语学校	乌鲁木齐外国语学校
安徽新华学院	安徽合肥新华学院
陕西国际贸易职院	陕西国际贸易职业学院
联大生化学院	北京联合大学生物化学工程学院
惠山	惠山区
卓资	卓资县
喀什	喀什地区	喀什市
乌松布拉	usumbura
卡诗	kerastase
创见	transcend
浙江经济职院	浙江经济职业学院	浙江经济职业技术学院
元谷	dat@age	datage
江西科技职院	江西科技职业学院
二炮工学院	第二炮兵工程学院	二炮工程学院
朔城	朔城区
柳南	柳南区
奥萨山	ossa
爱国卫生运动委员会	全国爱国卫生运动委员会
浙江工商职院	浙江工商职业学院	浙江工商职业技术学院
侧门	侧门口
古巴	古巴共和国
大冶	大冶市
温州机场	温州永强国际机场	温州国际机场	永强机场	永强国际机场
重庆三峡医专	重庆三峡医药高等专科学校	重庆三峡医药专科学校
琅勃拉邦	luangprabang
警院	警官职业学院	警职学院	警职院	警官学院
科迪亚	qdi
清科大	清云科大	清云科技大学
五原	五原县
北商大	北京工商大学
韶关职大	韶关市职工大学
金碧爱	g.b.r	gbr
东来顺	东来顺饭庄
龙华科大	龙华科技大学
图木舒克	图木舒克市
oriole	欧丽电子集团
美播	mpio
首信	shouxin
超达高技术研究所	宝鸡超达高技术研究所
双鹿	pairdeer
浦东机场	shanghaiinternationalairport	上海浦东国际机场	浦东国际机场
摩尔达维亚	moldavia
兴安	兴安县	兴安区	兴安市	兴安盟
饶阳	饶阳县
双滦	双滦区
宿迁	宿迁市
成都理工大工程技术学院	成都理工大学工程技术学院
日照	日照市
斯堪的那维亚半岛	scandinavia
微芯	microchip
走私大	中洲综合走读私立大学
北舞	北京舞蹈学院
井陉	井陉县	井陉矿区
山东现代职院	山东现代职业学院
广东电大	广东广播电视大学
绿化委员会	全国绿化委员会
梁平	梁平县
黎平机场	贵州黎平机场
少科院	少年航天科学院	少年科学院
客客通	kktone
仙台	sendai
巴彦淖尔	巴彦淖尔市
建湖	建湖县
cdt	世纪东唐
浙江	浙江省
湖北三峡职院	湖北三峡职业学院	湖北三峡职业技术学院
正蓝	正蓝旗
凤庆	凤庆县
基尔库克	kirkuk
讨好体院	讨好体院活动手艺学院
柳州运输职院	柳州运输职业学院	柳州运输职业技术学院
辽源	辽源市
安徽建工学院	安徽建筑工学院	安徽建筑学院	安徽建筑工业学院
魅力锡都	悠悠红河魅力锡都影院	魅力锡都影院	悠悠红河影院
浙江国际海运职院	浙江国际海运职业学院	浙江国际海运职业技术学院
江城	江城区	江城县	江城哈尼族彝族自治县	江城自治县
朋大	朋谊大学
盐城师范	江苏盐城师范学院	盐城师院	盐城师范学院
南郑	南郑县
新疆机电职院	新疆机电职业技术学院	新疆机电职业学院
玛米亚	mamiya
湖北开放职院	湖北开放职业学院	湖北开放职业技术学院
玄武	玄武区
贸大远程	贸易大学远程教育学院
粉冶院	中南大粉冶院	中南大学粉末冶金学院	中南大粉末冶金学院
西安文理	西安文理学院
科尔沁右翼中	科尔沁右翼中旗
红岩美容美发	丹东红岩美容美发学校
青岛海洋地质研究	青岛海洋地质研究所
宫廷服	宫廷服装
南郊	南郊区
防化学院	防化指挥工程学院
西藏夷易近院	西藏夷易近族学院
海丰	海丰县
香缇卡	chantecaille
大武口	大武口区
南江	南江县
仙桃	仙桃市
揭阳职院	揭阳职业学院	揭阳职业技术学院
成都艺职	成都艺术职业学院	成都艺术职院
圣基茨和尼维斯	圣革茨和尼维斯联邦
工院	工业学院
颜港小学	颜港中心小学
广阳	广阳区
创维	skyworth
泊头职院	泊头职业学院
厦门东海职院	厦门东海职业学院	厦门东海职业技术学院
公寓	公寓酒店	度假酒店	海景度假酒店	连锁快捷酒店	酒店公寓	大酒店	公寓式酒店	连锁酒店	宾馆	国际酒店	连锁宾馆	海景渡假酒店	时尚酒店	商务会馆	温泉商务会馆	hotel	国际宾馆	国际大饭店	快捷连锁酒店	商务宾馆	商务大酒店	渡假酒店	酒店	酒店式公寓	商务酒店	快捷酒店	国际大酒店	精品酒店	国际饭店	大饭店
大连外语大学	大连外国语大学
彭浦中学	上海市彭浦中学
泗阳	泗阳县
邢台电大	邢台广播电视大学
厦门海洋职院	厦门海洋职业技术学院	厦门海洋职业学院
吉大行政学院	吉林大学行政学院
洛阳理工	洛阳理工学院
广西交通职院	广西交通职业学院	广西交通职业技术学院
技师学院	邢台技师学院	深圳技师学院
法庭	人民法庭
西格拉摩根	westglamorgan
福建警职院	福建警官职业学院	福建警官职院
云龙	云龙区	云龙县
延安鲁艺	延安鲁迅艺术学院
快译通	gsl
舒城	舒城县
北京	北京市
云南新华电脑	云南新华电脑学院
监察部	国家监察部	中华人民共和国监察部	中国监察部
巴斯夫	basf
湖北第二师范	湖北第二师范学院	湖北第二师院
郑州电专	郑州电力专科学校	郑州电力高等专科学校
雨花台	雨花台区
大连医大	大连医科大	大连医科大学
沈交	沈交大	沈阳交通大学	沈阳交大
顺河	顺河区	顺河回族区
斗门	斗门区
天津城市建设管理职院	天津城市建设管理职业技术学院	天津城市建设管理职业学院
科利亚	柯利亚
桂平	桂平市
仙桃职院	仙桃职业学院
马拉巴海岸	malabarcoast
蓝天学院	江西蓝天学院
罗姆	rohm
北二外中瑞酒店管理学院	北京第二外国语学院中瑞酒店管理学院
北大口腔学院	北京大学口腔医学院	北大口腔医学院
ps	photoshop
麻阳	麻阳苗族自治县	麻阳县	麻阳自治县
云大滇池学院	云南大学滇池学院
斯沃琪	swatch
马六甲海峡	malacca
无锡职院	无锡职业学院	无锡职业技术学院
锡金	sikkim
太原机场	武宿机场	武宿国际机场	太原国际机场	太原武宿国际机场
山东工会学院	山东工会干部学院
澄城	澄城县
山东经管干	山东省经济管理干部学院	山东经济管理干部学院
雪佛兰	chevrolet	雪佛莱
乌克兰	ukraine
西林	西林区	西林县
湖南冷水江工业学校	湖南省冷水江工业学校
西影学院	西安电影培训学院
迪美	dmtech
印度洋	indianocean
长职院	长春职业学院	长春职业技术学院
孟加拉国	孟加拉人民共和国	bangladesh
乌兹别克	uzbekistan	乌e克斯坦
西陵	西陵区
吉隆	吉隆县
贵南	贵南县
青岛酒店管理职院	青岛酒店管理职业学院
本溪	本溪满族自治县	本溪市	本溪自治县	本溪县
麦立昂斯夏	merionethshire
燕大里仁学院	燕山大学里仁学院
攀大	攀枝花学院
中国政协	中国人民政治协商会议全国委员会	全国人民政协	中国政协全国委员会	中国人民政协全国委员会	全国政协	政协全国委员会
武指南昌分院	中国人民武装警察部队指挥学院南昌分院	武警指挥学院南昌分院
固始	固始县
新昌	新昌县
土拨鼠	vaudemarmot
国医	国防医学院
湖南现代物流职院	湖南现代物流职业学院	湖南现代物流职业技术学院
理光	ricoh
斯匹次卑尔根群岛	spitsbergen
新蔡	新蔡县
遵义医专	遵义医药专科学校	遵义医药高等专科学校
高级航校	中国民航高级飞行学院
淄川	淄川区
新财	新疆财经	新疆财大	新财大学	新疆财经大学
甘肃核工职大	甘肃核工业职大	甘肃核工业职工大学
黎川	黎川县
宁国	宁国市
天立外语	鸡西天立外国语学院
9	Ⅸ	第九	第9	玖	九	no9
人大经济学院	中国人大经济学院	人民大学经济学院	中国人民大学经济学院
古蔺	古蔺县
槐荫	槐荫区
呼伦贝尔	呼伦贝尔市
高安	高安市
安全部	中国国家安全部	国家安全部	中华人民共和国国家安全部	中华人民共和国安全部
广西经干院	广西经济管理干部学院
珠晖	珠晖区
河北旅游职院	河北旅游职业学院
西北师大	西北师范	西北师院	西北师范学院	西北师范大学
襄汾	襄汾县
梅河口	梅河口市
沃雅国院	沃雅国际学院
靖江	靖江市
澳西奴	澳西奴aussino	aussino
美信	maxim
天长	天长市
中国网	网上中国	中国互联网新闻中心
安徽矿业职院	安徽矿业职业技术学院	安徽矿业职业学院
雨山	雨山区
安徽广影职院	安徽广播影视职业技术学院	安徽广播影视职业学院
贝尔金	belkin
爱普泰克	aiptek
张家口教院	张家口教育学院
琼台师范	琼台师范高等专科学院
衢江	衢江区
福农大	福建农林大学	福建农大	福建农林大
鲁商院	鲁昂高等商学院	鲁昂高商
云南科技信息职院	云南科技信息职业学院
萨斯喀彻温	saskatchewan
陕经贸	陕西经贸学院
龙城	龙城区
丽家	丽家宝贝
亚东	亚东县
昭苏	昭苏县
香港中文大学威尔士亲王医院	princeofwaleshospital
汉滨	汉滨区
沈家门渔村	沈家门海鲜
天心	天心区
兰考	兰考县
露华浓	revlon
嘉定	嘉定区
马辛德拉	mahindra
宁夏工业职院	宁夏工业职业技术学院	宁夏工业职业学院
隆昌	隆昌县
北京外事学院	北京外事研修学院
江东	江东区
九大	九州大学
分宜	分宜县
伯爵	piaget
东河	东河区
阿克塞	阿克塞县	阿克塞哈萨克族自治县	阿克塞自治县
惠东	惠东县
上海城市管理职院	上海城市管理职业学院	上海城市管理职业技术学院
岱岳	岱岳区
江源	江源区
库藏	库存
东海	东海县
上海市立幼儿园	上海市市立幼儿园
以色列	israel	以色列国
久久鸭	久久丫
七台河	七台河市
葵青	葵青^
小龙武院	少林小龙武术学院
江都	江都市
黄南	黄南自治州	黄南市	黄南州	黄南藏族自治州
天津外语大学	天津外国语大学
北京爱迪曼	北京爱迪曼生物技术研究所
广东轻工职院	广东轻工职业学院	广东轻工职业技术学院
永亚学院	香港永亚软件学院
贤达学院	上外贤达学院	贤达经济人文学院	上外贤达经济人文学院	上海外国语大学贤达经济人文学院
武汉体院	武汉体育学院
计量学院	中国计量学院
国安局	国家安全局
圣萨尔瓦多	sansalvador
邵阳职院	邵阳职业技术学院	邵阳职业学院
克孜勒苏	克孜勒苏自治州	克孜勒苏柯尔克孜自治州	克孜勒苏市	克孜勒苏州
民诉法	民事诉讼法
特洛伊	troy
安多	安多县
高坚	cokin
青阳	青阳县
鄱阳	鄱阳县
马拉维	malawi	马拉维共和国
镇远	镇远县
深圳电大	深圳广播电视大学
镇原	镇原县
沧州师专	沧州师范专科学校
亚商	香港亚州商学院
阿克苏职院	阿克苏职业学院	阿克苏职业技术学院
江西制造职院	江西制造职业学院	江西制造职业技术学院
西南革大	西南人民革命大学
铁山	铁山区
湖南铁路科技职院	湖南铁路科技职业学院	湖南铁路科技职业技术学院
皮研所	皮肤病防治所	皮肤病研究所	皮防研究所	皮防所	皮肤病防治研究所
泰安机场	泰安直升机场
迁安	迁安市
湖南农大东方科技学院	湖南农业大学东方科技学院
云南电大	云南广播电视大学
埃及	阿拉伯埃及共和国
安定	安定区
朗科	netac	深圳市朗科科技有限公司
金沙	金沙县
cect	中电通信科技有限责任公司
蒙牛	蒙牛乳业
金山	金山区
周口	周口市
岳西	岳西县
斯凯岛	skye
屏商院	屏东商业技术学院
山东英才学院	山东英才职业技术学院	山东英才职业学院	山东英才职院
林产品	林产产品
井院	井冈山学院
迈瑞	micrel
电子工程学院	中国人民解放军电子工程学院	解放军电子工程学院
特教院	长春大学特殊教育学院	特教学院	特殊教育学院
宁都	宁都县
马格德堡	magdeburg
广西医大	广西医科大	广西医科大学
锦州银行	锦州市商业银行股份有限公司	bankofjinzhou	锦州市商业银行
崇仁	崇仁县
西工大明德学院	西北工业大学明德学院
卡耐基培训	上海卡耐基培训学校
马尔康	马尔康县
南通	南通市
广陵	广陵区
广灵	广灵县
三河	三河市
区少科院	南汇区青少年科学院
斯克莱	斯克莱连锁	斯克莱快捷	斯克莱连锁酒店	斯克莱快捷连锁酒店	斯克莱快捷酒店	斯克莱酒店	斯克莱连锁快捷酒店
浙江电大	浙江广播电视大学
广西农业职院	广西农业职业技术学院	广西农业职业学院
娄烦	娄烦县
马拉加	malaga
贵州科技工程职院	贵州科技工程职业学院
华坪	华坪县
吴忠	吴忠市
湖北职院	湖北职业学院	湖北职业技术学院
于田	于田县
农学院	农学学院
广西机电职院	广西机电职业学院	广西机电职业技术学院
常委	常委会	常务委员会
华桥外院	吉林华桥外国语学院	华桥外国语
甘泉外国语中学	中国上海甘泉外国语中学
吕勒奥	lulea
萨拉托加	saratoga
滦南	滦南县
武功	武功县
咸阳	咸阳市
五一学院	重庆市五一技师学院
丰田技校	辽宁丰田金杯技师学院
松原	松原市
马鞍山技师学院	安徽马鞍山技师学院
约克	york
山东铝业职院	山东铝业职业学院	山东铝业职业技术学院
东8门	东八门
凉城	凉城县
北塘	北塘区
重庆警官学院	重庆警官职业学院
菏泽医专	菏泽医学专科学校	山东菏泽医学专科学校
宇瞻	apacer
殷都	殷都区
林肯郡	lincolnshire
江苏农科院	江苏省农业科学院
武汉地干院	武汉地质科技管理干部学院
四川烹饪专科学校	四川烹饪高等专科学校
永安	永安市
重庆蒙妮坦	重庆蒙妮坦美容学院
天商大	天津商大	天津商业大学
德兴面馆	德兴汤面馆
思睿逻辑	cirruslogic
市政管委会	市政管理委员会
淳安	淳安县
蒙马特区	montmartre
上饶师范	上饶师范学院	上饶师院
汝南	汝南县
奥法利	offaly
郴州职院	郴州职业学院	郴州职业技术学院
北辰	北辰区
香港环球电讯社	香港环球经济电讯社
捷克	捷克共和国
复旦	复旦大学
一点	1点	壹点
定襄	定襄县
柳州螺丝粉	柳州螺蛳粉
罗定	罗定市
乌拉特后	乌拉特后旗
什邡	什邡市
烟草局	烟草专卖局	国家烟草专卖局
田阳	田阳县
京华	jwd
西华师大	西华师范	西华师范大学
农工委	农村工作委员会	农工委会
西安美术科技学院	西安美术科技培训学院
影视艺术学院	北京电影学院影视艺术学院
佛科院	佛山科学技术学院	佛山科技学院
流亭机场	青岛国际机场	流亭国际机场	青岛流亭国际机场	青岛机场
兰坪	兰坪自治县	兰坪白族普米族自治县	兰坪县
福建电大	福建广播电视大学
其乐	其乐购物
番禺电大	番禺区广播电视大学
杭州九中	杭州第九中学
合浦	合浦县
大港	大港区
工商局	工商总局	中华人民共和国国家工商行政管理总局	北京市工商局	市工商局	工商行政管理局	北京工商局	工商管理局	北京工商行政管理局	市工商行政管理局	北京市工商行政管理局	中国工商总局
税务总局	国家税务总局
军博	军事博物馆
南格拉摩根	southglamorgan
湘东	湘东区
济南企业家协会	济南市企业家协会
公安局	警察局
药房	药店
平泉	平泉县
东泽武院	安阳市东泽少林武术学院
中原工程学院	中原艺术工程学院
施甸	施甸县
解放军国关学院	中国人民解放军国际关系学院	解放军国际关系学院
福尔蒂	富通集团	fortis
屯t	屯t^
汤姆逊	tmson
新荣	新荣区
滨州职院	滨州职业学院
平壤	pyongyang
711	7eleven
印度河	indus
环翠	环翠区
旬邑	旬邑县
马鞍山职院	马鞍山职业学院	马鞍山职业技术学院
连大	大连大学
浙江省农函大	浙江省农村致富技术函授大学
外经贸	对外经济贸易大学	外经贸大学	对外贸易大学	对外经贸大学	外经济贸易大学
金华交警支队	金华市公安局交警支队
秦皇岛外语职院	秦皇岛外国语职业学院	秦皇岛外语职业学院
郑大	郑州大学
青大昆仑学院	青海大学昆仑学院
万方学院	万方科技学院
西南大社院	西南大社会主义学院	西南大学社会主义学院
迪梵	darphin
惠水	惠水县
红旗业大	宣武红旗业余大学
兄弟高登	高登眼镜	兄弟高登眼镜
牟平	牟平区
清浦	清浦区
江夏	江夏区
中兴初级中学	重庆市开县中兴初级中学
宜良	宜良县
武隆	武隆县
东方学院	东方专修学院	黑龙江东方学院
荆楚教院	荆楚理工学院国际教育学院
砀山	砀山县
建材市场	建筑装饰材料批发市场	建材批发市场	建筑装饰材料市场	建筑材料市场	建筑材料批发市场
湖南电气职院	湖南电气职业技术学院	湖南电气职业学院
乌拉圭	乌拉圭东岸共和国	uruguay
吉林建工学院建筑装饰学院	吉林建筑工程学院建筑装饰学院
歌宝婷	calotine
新医三全学院	新乡医学院三全学院
郴州医专	郴州医学高等专科学校	郴州医学专科学校
临城	临城县
沙坡头	沙坡头区
全州	全州县
e河	e河区	e河回族区
东南2门	东南二门
纳兹卡	mazca
舟曲	舟曲县
塞勒姆	salem
兰航大	兰州航空大学	兰州航空工业职工大学	兰州航空工业大学
神宏桥教学仪器研究所	北京神宏桥教学仪器研究所
长春医专	长春医学高等专科学校	长春医学专科学校
好莱客	好莱客整体衣柜
甘南	甘南自治州	甘南县	甘南州	甘南市	甘南藏族自治州
塔城电大	塔城广播电视大学
扶沟	扶沟县
和平	和平区	和平县
邢台	邢台县	邢台市
创豪启钧	keewin
中央圣马丁	中央圣马丁艺术学院
阜新师专	阜新师范专科学校
英国	大不列颠及北爱尔兰联合王国	unitenkingdom	uk
吕梁	吕梁市
姑苏	苏州市	苏州
天等	天等县
吴江二中	吴江市第二高级中学
法大	中国政法大学	中国法大	中政大	政法大学
话剧院	话剧剧院
满洲里	满洲里市
布伊格	bouygues
北京新圆明职院	北京新圆明职业学院
易拓	excelstor
通江	通江县
曼诗贝丹	marjoriebertagne
湖南国防科大	湖南国防科技大学
福教院	福建教育学院	福州教育学院
蕉岭	蕉岭县
计测学院	计量测试工程学院
快餐店	快餐馆	快餐连锁店	连锁店
冰箱	电冰箱
新安职院	新安职业技术学院	新安职业学院
纳闽岛	labuan
毛里求斯	毛里求斯共和国
内科大	内蒙古科技大学	内蒙古科大
台山电大	台山磐石电视大学
上海海事职院	上海海事职业技术学院	上海海事职业学院
牡丹江	牡丹江市
大同大学工学院	山西大同大学工学院
全国老龄工委	全国老龄工作委员会
云大旅游文化学院	云南大学旅游文化学院
广师大	广西师范学院	广西师范大学	广西师范	广西师大	广西师院
嘉娜宝	kanebo	嘉纳宝
栎社机场	宁波国际机场	宁波机场	栎社国际机场	宁波栎社国际机场
格林豪泰	greentreeinns	格林豪泰连锁	格林豪泰酒店	格林豪泰连锁酒店
河南工业职院	河南工业职业学院	河南工业职业技术学院
六盘水师院	六盘水师范学院	六盘水师范
湖商院	湖南商院	湖南商学院
宣德瓷	宣德瓷器
马利布	malibu
渣打	charteredbank	中国渣打银行	美国渣打银行	标准渣打银行	渣打银行(中国)有限公司	渣打银行	standardcharteredbank	标准银行
陕西省电大	陕西省广播电视大学
博达学院	上海博达进修学院
济南铁道职院	济南铁道职业学院	济南铁道职业技术学院
措美	措美县
上海内威	上海内威职业技术学校
建大	建设大学
港科大	香港科大	香港科技大学
嘉鱼	嘉鱼县
沿滩	沿滩区
西南3门	西南三门
昌安实验学校	绍兴市昌安实验学校
盈江	盈江县
芜湖	芜湖县	芜湖市
阿佩胡峰	ruapehu
南方动力机械公司职工学院	南方动力机械公司职工工学院
日东	nitto
辽医	辽宁医学院
湖北城市建设职院	湖北城市建设职业学院	湖北城市建设职业技术学院
劳关学院	劳动关系学院	中国劳动关系学院
绵阳电大	绵阳广播电视大学
庐山	庐山区
浏阳农村商业银行	湖南浏阳农村商业银行	湖南浏阳农村商业银行股份有限公司
普拉达	prada
中间美院	中间美术学院
清山侨大	清山华侨大学
川剧院	川剧剧院
新日铁	nipponsteel
常州机电职院	常州机电职业学院	常州机电职业技术学院
老胡记	老胡记棒棒鸡
闵行	闵行区
江北	江北区
墨西哥餐厅	tacopopo
高登姐妹	高登姐妹购物城
锦州地产交易中心	锦州市地产交易中心
南康	南康市
萨德伯里	sudbury
景谷	景谷傣族彝族自治县	景谷县	景谷自治县
纪念物	纪念品
黑龙江农业经济职院	黑龙江农业经济职业学院
宁教院	宁波教育学院
李光耀学院	李光耀公共政策学院
亚新大	亚洲新南威尔斯大学
诺威奇	norwich
李嘉子	李嘉子形象设计
垣曲	垣曲县
徐记	徐记海鲜
安大	安徽大学	徽大
扶贫开发领导小组	国务院扶贫开发领导小组
福建金融学院	福建金融职业学院	福建金融职院	福建金融职业技术学院
吉林建工学院	吉林建筑学院	吉林建筑工程学院	吉林建筑工学院
武汉外语外事职院	武汉外语外事职业学院
电监局	国家电力监管局	电力监管局
爱尚你婚庆	爱尚你婚庆加盟连锁机构
长春汽专	长春汽车工业高等专科学校	长春汽工专科学校	长春汽车工业专科学校
北京电子科技职院	北京电子科技职业学院
山阴	山阴县
耒阳	耒阳市
湖北水利水电职院	湖北水利水电职业学院	湖北水利水电职业技术学院
汽配	汽车美容	汽车维修	汽车装饰美容	汽车生活馆	汽车修理部	汽车美容中心	汽车修配	汽车配件	汽车装饰美容中心	汽车修理	汽车装饰	汽车服务部	汽修	汽车装饰中心
东9门	东九门
安达	安达市
金塔	金塔县
鸿德国际学校	内蒙古师范大学鸿德学院
云南能源职院	云南能源职业学院	云南能源职业技术学院
苏瓦	suva
阿克陶	阿克陶县
海门	海门市
社保基金会	社保基金理事会	社会保障基金理事会	全国社会保障基金理事会
掇刀	掇刀区
斯巴鲁	subaru
驻京办	驻北京联络处	驻北京接待处	驻京联络处	驻京接待处	驻京办事处	驻北京办事处
安次	安次区
萨洛普	salop
运城	运城市
宣传站	推广站
支委	支委会	支部	支部委员会
长春景机学院	长春景学精密机械学院
昆医	昆明医学院
安徽警官职院	安徽警官职业学院
德昌	德昌县
玛沁	玛沁县
仪征	仪征市
西雅图	seattle
于都	于都县
江财现代经济管理学院	江西财经大学现代经济管理学院
金水	金水区
万宝龙	blanc
巴林左	巴林左旗
北开大学	黑龙江北开大学
慈溪	慈溪市
乡建院	四川省乡村建设学院
阜南	阜南县
浙江长征职院	浙江长征职业学院	浙江长征职业技术学院
湖南财专	湖南财经高等专科学校	湖南财经专科
九寨沟	九寨沟县
朝鲜	朝鲜民主主义人民共和国
那曲	那曲市	那曲县	那曲地区
莱山机场	烟台莱山国际机场	烟台莱山机场	烟台机场	莱山国际机场	烟台国际机场
长海	长海县
扬中	扬中市
永靖	永靖县
首师大	首都师范	首都师大	首都师范大学
内大	内蒙古大学
佳泰砂锅	嘉泰沙锅
互助	互助自治县	互助土族自治县	互助县
好口福	好口福小吃
危地马拉	危地马拉共和国
江苏青管干	江苏省青年管理干部学院	青年管理干部学院
戏曲学院	台湾戏曲学院
右江民族医院	右江民族医学院
安徽机电职院	安徽机电职业学院	安徽机电职业技术学院
吉利	吉利区
西峡	西峡县
道真	道真自治县	道真县	道真仡佬族苗族自治县
沃尔玛	wal-mart	walmart	walmartstores	wal-martstores
西夏	西夏区
无锡城职院	无锡城市职业技术学院	无锡城市职业学院
常德电大	常德广播电视大学
漯河职院	漯河职业技术学院	漯河职业学院
商科大学	武昌商科大学
南圆科大	南圆科技大学
信阳	信阳市
山东商务职院	山东商务职业学院
乌兰察布	乌兰察布市
防城港	防城港市
西乡	西乡县
马沙拉蒂	mashalatti	maserati	玛莎拉蒂
柯达	kodak
香坊	香坊区
芦山	芦山县
云和	云和县
临泽	临泽县
石屏	石屏县
贞丰	贞丰县
东大成教院	东大成人教育学院	东南大学成人教育学院
酒泉职院	酒泉职业学院	酒泉职业技术学院
里维埃拉	rivera
弗吉尼亚	virginia
桥	桥区
华侨大学成教院	华侨大学成人教育学院
扎赉特	扎赉特旗
沈阳理工大应用技术学院	沈阳理工大学应用技术学院
装院	装甲兵学院
足球馆	足球场
江西旅游商职院	江西旅游商贸学院	江西旅游商贸职业学院	江西旅游商学院
金泰克	kingtiger
温江	温江区
安化	安化县
泗洪	泗洪县
华东勘测研究院	华东勘测设计研究院
英院	英语学院
浙江理工大科技与艺术学院	浙江理工大学科技与艺术学院
林口	林口县
桂林空院	桂林空军学院
永定	永定县	永定区
象州	象州县
麻山	麻山区
盈通	yeston
龙南	龙南县
波音	boeing
深水	深水^
山东矿院	山东矿业学院
天成中心小学	乐清市天成乡中心小学
泉州医专	泉州医学高等专科学校	泉州医学专科学校
广西城市职院	广西城市职业学院
超视能	maxian
上大时装学院	上海大学巴黎国际时装艺术学院	巴黎国际时装艺术学院	上大时装艺术学院
宝兴	宝兴县
青海电大	青海广播电视大学
阳江电大	阳江电视大学
西航院	西安航空旅游学院	西安航空学院
韦尔斯利	wellesley
电视	彩电	电视机	彩色电视
不丹	不丹王国	bhutan
帝陀	tudor
英文学院	英语语言文化学院
西峰	西峰区
西丰	西丰县
蓝田机场	泸州蓝田机场	泸州机场
寻乌	寻乌县
武汉交通职院	武汉交通职业学院
连南	连南自治县	连南瑶族自治县	连南县
藏医	西藏藏医学院
东7门	东七门
多哥	多哥共和国
西纺	西北纺织学院
中海大青院	中海大青岛学院	海洋大学青岛学院	中国海洋大学青岛学院	海大青岛学院	中国海大青岛学院
利比里亚	liberia	利比里亚共和国
元培科大	元培科技大学
惠安	惠安县
业余工大	业余工业大学
汉城	seoul
天译	天津翻译学院
鄞州	鄞州区
东港	东港市	东港区
洪湖	洪湖市
八一农学院	新疆八一农学院
德化陶职院	德化陶瓷职院	德化陶瓷职业技术学院
金菇牛肉卷	金针菇牛肉卷
浸大国际学院	香港浸会大学国际学院
克旗	克什克腾旗	克什克腾
江艺	江西艺术设计学院
北京北大方正软件职院	北京北大方正软件职业技术学院	北京北大方正软件职业学院
福茂龙虾	复茂小龙虾
盐亭	盐亭县
飘柔	rejoice
大城	大城县
北津学院	湖南商学院北津学院
振兴	振兴区
江阴	江阴市
天医	医大	天津医科大	医科大	天津医科大学	医科大学	天津医大
西电高职	西安电子科技大学高等职业学院
阿什哈巴	ashkhabad
拱墅	拱墅区
济南	济南市
荥经	荥经县
嘉大	嘉义大学	嘉应学院
光胤	光胤瑜伽
黄浦	黄浦区
黄埔	黄埔区
西安机场	咸阳国际机场	西安国际机场	咸阳机场	西安咸阳国际机场
三门	三门县
奥马哈	omaha
欧珀莱	aupres
北京音乐学院	北京现代音乐研修学院	现代音乐学院
河北化工医药职院	河北化工医药职业学院	河北化工医药职业技术学院
君山	君山区
hb	华夏银行	huaxiabank	华夏银行股份有限公司
瓦城	mandalay
宁夏建设职院	宁夏建设职业技术学院	宁夏建设职业学院
巩留	巩留县
复旦太平洋金融学院	复旦大学太平洋金融学院
麒麟	麒麟区
南邮吴江学院	南京邮电大学吴江职业技术学院
毕节	毕节地区	毕节市
雨花	雨花区
昆都仑	昆都仑区
棉兰友好学院	棉兰亚洲国际友好学院
斯可斐峰	scafellpike
三明	三明市
爱科电通	adico
漯河医专	漯河医学高等专科学校	漯河医学专科学校
郑铁局	郑州铁路局
cube	酷比魔方
聂拉木	聂拉木县
甘洛	甘洛县
聊城职院	聊城职业学院	聊城职业技术学院
东北石油	东北石油学院
元江	元江县	元江哈尼族彝族傣族自治县	元江自治县
锡林浩特	锡林浩特市
上合组织大学	上海合作组织大学
华泰康宁中医药研究所	北京华泰康宁中医药研究所
移动	中国移动
琼结	琼结县
供销合作总社	陕西省供销合作总社	陕西供销合作总社
卫滨	卫滨区
suez	苏伊士里昂	苏伊士运河	苏伊士地峡	苏伊士里昂水务
qq	腾讯科技(北京)有限公司	腾讯科技(深圳)有限公司	腾讯科技(上海)有限公司	腾讯qq	腾讯控股有限公司	深圳市腾讯计算机系统有限公司上海分公司	深圳市腾讯计算机系统有限公司	腾讯	tencent	腾讯科技(成都)有限公司
亭湖	亭湖区
网院	华师大网络学院	网络教育学院	网络学院	华东师范大学网络学院
临桂	临桂县
鲤城	鲤城区
吉林电大	吉林广播电视大学
戏剧院	戏剧剧院
桂林电科大	桂林电子科技大学
屠场	屠宰场
上期所	上海期货交易所	上海期交所
甘肃畜牧工程职院	甘肃畜牧工程职业学院	甘肃畜牧工程职业技术学院
市委	市委会	市委员会	市市委	市市委会	市市委员会
博兴	博兴县
北市	北市区
中站	中站区
天主堂	天主教堂
广美	广州美术学院	广州美院
绥滨	绥滨县
湛江电大	湛江市广播电视大学
崇文	崇文区
纽卡斯尔	newcastle
郑大商学院	郑州大学商学院
北航软件学院	北京航空航天大学软件学院
周口科技职院	周口科技职业学院
湖口	湖口县
中银国际香港	香港中银国际
财产	资产
南溪	南溪县
抚松	抚松县
独山子	独山子区
科职大	科技职工大学
抚顺	抚顺县	抚顺市
斯莱戈	sligo
桐城	桐城市
盘谷银行	bankofbangkok
灵宝	灵宝市
华容	华容区	华容县
大竹	大竹县
淮南职院	淮南职业学院	淮南职业技术学院
国务院扶贫办	国务院扶贫开发领导小组办公室
东青美容美发学校	北京东青美容美发学校
华软	华软软件学院
冷水滩	冷水滩区
台大社科院	台湾大学社会科学院
信管院	信管学院	信息管理学院
邓州	邓州市
三峡机场	宜昌三峡机场	宜昌机场
维西	维西自治县	维西县	维西傈僳族自治县
张家港学院	江苏广播电视大学张家港学院
忻州师范专	忻州师范高等专科学校	忻州师范专科学校
江西工业贸易职院	江西工业贸易职业技术学院	江西工业贸易职业学院
新岳	newdelhi
国开行	开发银行	chinadevelopmentbank	国家开发银行	cdb
宁夏师范	宁夏师范学院	宁夏师院
鸿星尔克	hongxingerke
军工学院	军械工程学院	中国人民解放军军械工程学院
华润	华润万家
四川	四川省
康骏会馆	康骏ceo会馆
肇庆医专	肇庆医学专科学校	肇庆医学高等专科学校
沈阳化大科亚学院	沈阳化工大学科亚学院
呼玛	呼玛县
南京工业职院	南京工业职业技术学院	南京工业职业学院
兴华学院	长安大学兴华学院
连江水利职院	连江水利职业学院	连江水利职业技术学院
金州	金州区
图卜卡勒山	toubkal
湘杏学院	湖南中医大湘杏学院	中医药湘杏学院	中医药大学湘杏学院	中医大学湘杏学院	湖南中医药湘杏学院	湖南中医药大学湘杏学院	中医大湘杏学院	湖南中医大学湘杏学院
安阳	安阳县	安阳市
南大医学院	南昌大学医学院
福建水利电力职院	福建水利电力职业学院	福建水利电力职业技术学院
bbk	广东步步高电子工业有限公司	步步高
南京琅琊路小学	南京市琅琊路小学
长沙通信职院	长沙通信职业学院	长沙通信职业技术学院
国资局	国有资产监督局	国有资产监督管理局
东北8门	东北八门
陕西师大出版社	陕西师范大学出版社
新干线日语专修学校	厦门专业日语培训学校
中科万维数字	中科万维数字教育学院
循化	循化自治县	循化撒拉族自治县	循化县
全国总工会	中华全国总工会
职防院	职业病防治院
正德学院	正德职业学院	正德职业技术学院
甘肃林业职院	甘肃林业职业学院	甘肃林业职业技术学院
乌兰浩特	ulanhot	乌兰浩特市
激流	急流
南京电大	南京广播电视大学
建水	建水县
天晟茶艺	天晟茶艺培训学院
火凤凰	火凤凰文化协会
天星艺术学院	天星影视艺术学院
白朗	白朗县
明水	明水县
苍梧	苍梧县
京华医科大学	北京京华医科大学
洱源	洱源县
富可视	infocus
优百特	unibit
崇阳	崇阳县
哈尔滨电力职院	哈尔滨电力职业技术学院	哈尔滨电力职业学院
公务员局	国家公务员局
无锡商业职院	无锡商业职业学院	无锡商业职业技术学院
罗沙峰	rosamonte
钟祥	钟祥市
合肥师院	合肥师范	合肥师范学院
湘潭电大	湘潭广播电视大学
依云	evian
宛城	宛城区
清涧	清涧县
奉化	奉化市
马普托	maputo
林恩	lynn
新疆工专	新疆工业高等专科学校	新疆工业专科学校
武候英艺幼儿园	成都市武候区英艺幼儿园
曲靖医专	曲靖医学高等专科学校	曲靖医学专科学校
猗园	古猗园
帕杰罗	pajero
沧浪	沧浪区
8小	第8小学	第八小学	八小
乳山	乳山市
青岛航空学院	青岛航空技术专修学院
陕师大网院	陕西师范大学网络教育学院
职高	职业高中
重庆青年职院	重庆青年职业技术学院	重庆青年职业学院
九里	九里区
盐城卫生职院	盐城卫生职业技术学院	盐城卫生职业学院
洮北	洮北区
肇庆科技职院	肇庆科技职业技术学院	肇庆科技职业学院
鱼台	鱼台县
沈北	沈北区	沈北新区
滨海学院	南大滨海学院	南开大学滨海学院
上海木材工业所	上海木材工业研究所
魏玛	weimar
力士	lux
环保所	环境保护所	环境保护监督管理所	环境保护管理所
珠海电大	珠海广播电视大学
商水	商水县
吉普	jeep
洛桑	lausanne
如东	如东县
郑州电大	郑州广播电视大学
拉克代夫群岛	laccadiveisland
迪庆机场	迪庆香格里拉机场	香格里拉机场
会同	会同县
房地产权	房地产产权
兰伯达	lambda
北方车辆研究所	中国北方车辆研究所
千	仟
拉达	lada
临西	临西县
微科	weike
新华街道办	新华街道办事处
青岛电大	青岛广播电视大学
临邑	临邑县
连江附小	连江附属小学
迪庆	迪庆自治州	迪庆州	迪庆市	迪庆藏族自治州
国教院	国教学院	国际教育学院
江河水库管理局	陕西省江河水库管理局
育成翻译培训中心	上海卢湾区育成翻译培训中心
临沂	临沂市
尼古拉	nikula
天狮学院	天津天狮学院	天狮职业技术学院
汉知语言培训学院	深圳市汉知语言培训学院
云浮	云浮市
阜平	阜平县
天津商院宝德英华美学院	天津商学院宝德英华美学院
尤卡坦	yucatan
史家小学分校	北京史家小学分校
高丝	kose
沈药大	沈阳药大	沈阳药科大	沈阳药科大学
西南大	西南大学
从江三中	贵州省从江县第三民族中学
计生中心	计划生育服务中心	计划生育中心	计生服务中心
深规院	深圳市城市规划设计研究院
黄冈	黄冈市
重庆工商学院	重庆工商职业学院	重庆工商职院	重庆工商职业技术学院
国务院妇女儿童工委	国务院妇女儿童工作委员会
美院	美术学院
韩国	northkorea	korea	大韩民国
福州黎明职院	福州黎明职业学院	福州黎明职业技术学院
拜泉	拜泉县
湖南软件职院	湖南软件职业学院
知产局	知识产权局	中华人民共和国国家知识产权局
柳州电大	柳州市广播电视大学
漳州城市职院	漳州城市职业学院
武威职院	武威职业学院	武威职业技术学院
达州	达州市
思科	cisco
歌顿	歌顿咖啡
闷锅	焖锅
地窝铺机场	乌鲁木齐机场	地窝铺国际机场	乌鲁木齐国际机场	乌鲁木齐地窝堡国际机场
温医	温州医学院
山东警院	山东警察学院
山东电子职院	山东电子职业技术学院	山东电子职业学院
小	小学	附小	初级小学	初小	附属小学	小学校
欧登塞	odense
汉剧院	汉剧剧院
乐安	乐安县
西北师大知行学院	西北师范大学知行学院
昌邑	昌邑区	昌邑市
盐津	盐津县
景观	景色	风景
白城医专	白城医学专科学校	白城医学高等专科学校
药学院	药学学院
佳能	canon
北京八十中	北京市第八十中学
电气学院	电气工程学院
重庆财经职院	重庆财经职业学院
伊特斯健身	伊特斯国际健身培训学院
南苑机场	北京南苑机场
owl	澳维力
西电	电科大	电子科技大	电子科大	西安电子科大	西安电子科技大学	湘潭电子科技大学	电子科技大学	西安电子科技大
交大	西交	西安交通大学	西交大	上交大	交通大学	西南交大	西南交通大学	北交大	西安交大	北交	上海交通大学	北京交通大学	上海交大	上交	北京交大
五华	五华县	五华区
山东城市建设职院	山东城市建设职业学院
利津	利津县
东方时尚驾校	北京市东方时尚机动车驾驶学校
碾子山	碾子山区
回民	回民区
武大东湖分校	武汉大学东湖分校
麦地那	medina
星辰通信	星辰通信国际控股
沈阳建工学院	沈阳建筑工程学院	沈阳建筑工学院	沈阳建筑学院
驻马店电大	驻马店广播电视大学
上师大	上海师大	上海师范大学	上海师范
汕头职院	汕头职业技术学院	汕头职业学院
内江师范	内江师范学院	内江师院
科管院	科技管理学院	科管学院
乌什	乌什县
劳斯	louth
保山中医专	保山中医药专科学校	保山中医药高等专科学校
斐乐	fila
龙凤	龙凤区
东京	tokyo
广州体职院	广州体育职业学院	广州体育职业技术学院
东莞电大	东莞市广播电视大学
天元	天元区
卫视	卫星电视
苏大	苏州大学
孟州	孟州市
连平	连平县
仁和百草	北京仁和百草中医药研究院
要德	要德火锅
4院	四医院	第四医院	4医院	四院	第四人民医院	第4人民医院	第4医院
计生	计划生育
浦东新区拉丁舞培训	浦东新区国际标准舞培训中心
西北7门	西北七门
铁东	铁东区
东北石油华瑞学院	东北石油学院华瑞学院
上饶电大	上饶广播电视大学
北婆罗洲	northborneo
德安	德安县
定边	定边县
恩斯新医药学院	广西中医药学院赛恩斯新医药学院	中医学院赛恩斯新医药学院	赛恩斯新医药学院	中医药赛恩斯新医药学院	广西中医院赛恩斯新医药学院	广西中医药赛恩斯新医药学院	中医药学院赛恩斯新医药学院	中医院赛恩斯新医药学院	广西中医学院赛恩斯新医药学院
六盘水职院	六盘水职业技术学院	六盘水职业学院
克拉玛依	克拉玛依市	karamay	克拉玛依区
成都职院	成都职业学院	成都职业技术学院
海陵	海陵区
大连外语学院	大连外国语学院
积家	jaegerlecoultre
海林	海林市
敖得萨	odessa
武指西宁分院	武警指挥学院西宁分院	中国人民武装警察部队指挥学院西宁分院
山西政管干	山西政法管理干部学院	山西政管干学院
山西国商学院	山西国商职院	山西国际商务学院	山西国际商务职业学院
济阳	济阳县
尼科西亚	nicosia
巴一中	巴东一中	巴东县第一高级中学
苏仙	苏仙区
西工大网院	西工大网络教育学院
北京应大	北京应用技术大学
商策学院	商务策划学院
繁峙	繁峙县
封丘	封丘县
乘车站	乘车车站
旺阿努伊	wanganui
内华达	nevada
甘肃警职院	甘肃警察职业学院	甘肃警察职院
文物局	国家文物局	文物管理局	文物事业管理局
漳州职院	漳州职业技术学院	漳州职业学院
延吉	延吉市
西北4门	西北四门
凤凰	凤凰县
蒙山	蒙山县
起亚	kia
杭锦后	杭锦后旗
宿城	宿城区
凌云	凌云县
南阳师院	南阳师范学院	南阳师范
游仙	游仙区
江西陶瓷工艺美院	江西陶瓷工艺美术职业技术学院
营业所	营业厅	合作厅
泾川	泾川县
清远侨大	清远华侨大学
乒乓球场	乒乓球馆
出口	出站口
入口	入站口
门诊	门诊部
急诊	急诊部	急症部
耳鼻喉	耳鼻喉科
宴会厅	大宴会厅
火锅	原生态火锅	红油火锅
食品店	食品商店
佳园	岭南佳园
会所	休闲会所
新动力	新动力外语学校	新动力学校
公安局	公安分局
分院	院区
老边饺子	老边饺子馆
速8	速8酒店	速8连锁酒店
青鸟	北大青鸟
金泉广场	金泉时代
市政管委	市政市容管委	市政管理委员会	市政市容管理委员会
亚洲大药房	亚洲药店	亚洲药房	亚洲大药店
新址	新台址
烤肉	烤肉超市
宁园	北宁公园
千喜	千禧
喜堡	cibo
华堂	伊藤洋华堂	华堂商场	ito-yokado	itoyokado
瓦罐汤	瓦罐煨汤
面包新语	breadtalk
汽销	汽车销售
